sub_num,block,diff,galaxy,opt_prt,prt,true_planet,n_galaxy
0.0,1,-1,0,2,1,0,1
0.0,1,-1,0,2,1,1,2
0.0,1,1,1,3,4,2,1
0.0,1,-2,1,3,1,3,2
0.0,1,0,1,3,3,4,3
0.0,1,3,2,5,8,5,1
0.0,1,4,2,6,10,6,2
0.0,1,3,2,7,10,7,3
0.0,1,1,0,2,3,8,1
0.0,1,1,0,2,3,9,2
0.0,1,0,0,2,2,10,3
0.0,1,1,0,2,3,11,4
0.0,2,2,0,2,4,20,5
0.0,2,0,0,2,2,21,6
0.0,2,1,0,2,3,22,7
0.0,2,4,2,7,11,23,1
0.0,2,4,2,6,10,24,2
0.0,2,3,2,6,9,25,3
0.0,2,3,2,6,9,26,4
0.0,2,4,2,7,11,27,5
0.0,2,2,1,2,4,28,1
0.0,3,2,1,2,4,40,2
0.0,3,4,2,6,10,41,1
0.0,3,2,1,2,4,42,1
0.0,3,2,1,2,4,43,2
0.0,3,2,1,2,4,44,3
0.0,3,2,1,2,4,45,4
0.0,3,3,2,7,10,46,1
0.0,3,3,2,6,9,47,2
0.0,3,2,1,2,4,48,1
0.0,3,1,1,3,4,49,2
0.0,4,1,0,2,3,60,1
0.0,4,1,0,2,3,61,2
0.0,4,1,0,2,3,62,3
0.0,4,3,2,6,9,63,1
0.0,4,3,2,6,9,64,2
0.0,4,4,2,7,11,65,3
0.0,4,3,2,8,11,66,4
0.0,4,3,2,6,9,67,5
0.0,4,2,2,6,8,68,6
0.0,5,1,1,2,3,80,1
0.0,5,0,1,3,3,81,2
0.0,5,1,1,2,3,82,3
0.0,5,1,1,2,3,83,4
0.0,5,1,1,2,3,84,5
0.0,5,1,1,2,3,85,6
0.0,5,1,1,2,3,86,7
0.0,5,1,1,2,3,87,8
0.0,5,1,1,2,3,88,9
0.0,5,1,1,2,3,89,10
0.0,5,1,1,2,3,90,11
0.0,5,1,1,2,3,91,12
0.0,5,0,1,3,3,92,13
0.0,5,1,1,2,3,93,14
1.0,1,-1,0,2,1,0,1
1.0,1,-1,0,2,1,1,2
1.0,1,1,1,3,4,2,1
1.0,1,2,1,2,4,3,2
1.0,1,2,1,2,4,4,3
1.0,1,3,2,7,10,5,1
1.0,1,3,2,5,8,6,2
1.0,1,4,2,7,11,7,3
1.0,1,1,0,2,3,8,1
1.0,1,1,0,2,3,9,2
1.0,1,0,0,2,2,10,3
1.0,1,0,0,2,2,11,4
1.0,2,0,0,2,2,20,5
1.0,2,0,0,2,2,21,6
1.0,2,0,0,2,2,22,7
1.0,2,2,2,7,9,23,1
1.0,2,4,2,6,10,24,2
1.0,2,3,2,6,9,25,3
1.0,2,3,2,7,10,26,4
1.0,2,3,2,7,10,27,5
1.0,2,2,1,2,4,28,1
1.0,2,-2,2,6,4,29,1
1.0,3,1,1,2,3,40,1
1.0,3,0,2,7,7,41,1
1.0,3,1,1,2,3,42,1
1.0,3,1,1,2,3,43,2
1.0,3,1,1,2,3,44,3
1.0,3,1,1,2,3,45,4
1.0,3,3,2,6,9,46,1
1.0,3,4,2,7,11,47,2
1.0,3,2,1,2,4,48,1
1.0,3,2,1,2,4,49,2
1.0,3,2,2,5,7,50,1
1.0,4,0,0,2,2,60,1
1.0,4,0,0,2,2,61,2
1.0,4,0,0,2,2,62,3
1.0,4,0,2,6,6,63,1
1.0,4,1,2,6,7,64,2
1.0,4,0,2,6,6,65,3
1.0,4,4,2,8,12,66,4
1.0,4,3,2,7,10,67,5
1.0,4,3,2,7,10,68,6
1.0,4,0,0,2,2,69,1
1.0,5,2,1,2,4,80,1
1.0,5,2,1,2,4,81,2
1.0,5,1,1,3,4,82,3
1.0,5,2,1,2,4,83,4
1.0,5,2,1,2,4,84,5
1.0,5,2,1,2,4,85,6
1.0,5,2,1,2,4,86,7
1.0,5,2,1,2,4,87,8
1.0,5,2,1,2,4,88,9
1.0,5,2,1,2,4,89,10
1.0,5,2,1,2,4,90,11
1.0,5,2,1,2,4,91,12
1.0,5,-1,1,2,1,92,13
2.0,1,0,0,2,2,0,1
2.0,1,-1,0,2,1,1,2
2.0,1,-2,1,3,1,2,1
2.0,1,-2,1,3,1,3,2
2.0,1,-2,1,3,1,4,3
2.0,1,-8,2,9,1,5,1
2.0,1,2,2,8,10,6,2
2.0,1,4,2,6,10,7,3
2.0,1,0,0,2,2,8,1
2.0,1,1,0,2,3,9,2
2.0,1,1,0,2,3,10,3
2.0,1,0,0,2,2,11,4
2.0,1,0,0,2,2,12,5
2.0,1,-1,2,6,5,13,1
2.0,2,0,0,2,2,20,1
2.0,2,0,0,2,2,21,2
2.0,2,0,0,2,2,22,3
2.0,2,2,2,7,9,23,1
2.0,2,2,2,6,8,24,2
2.0,2,3,2,8,11,25,3
2.0,2,3,2,7,10,26,4
2.0,2,3,2,6,9,27,5
2.0,2,2,1,2,4,28,1
2.0,2,-2,2,7,5,29,1
2.0,3,1,1,2,3,40,1
2.0,3,0,2,6,6,41,1
2.0,3,1,1,2,3,42,1
2.0,3,1,1,2,3,43,2
2.0,3,0,1,3,3,44,3
2.0,3,1,1,2,3,45,4
2.0,3,0,2,7,7,46,1
2.0,3,4,2,5,9,47,2
2.0,3,1,1,2,3,48,1
2.0,3,2,1,2,4,49,2
2.0,3,3,2,6,9,50,1
2.0,4,0,0,2,2,60,1
2.0,4,1,0,2,3,61,2
2.0,4,0,0,2,2,62,3
2.0,4,3,2,7,10,63,1
2.0,4,3,2,6,9,64,2
2.0,4,3,2,7,10,65,3
2.0,4,3,2,7,10,66,4
2.0,4,5,2,6,11,67,5
2.0,4,2,2,7,9,68,6
2.0,5,1,1,2,3,80,1
2.0,5,1,1,2,3,81,2
2.0,5,1,1,2,3,82,3
2.0,5,0,1,3,3,83,4
2.0,5,1,1,2,3,84,5
2.0,5,1,1,2,3,85,6
2.0,5,1,1,2,3,86,7
2.0,5,1,1,2,3,87,8
2.0,5,1,1,2,3,88,9
2.0,5,2,1,2,4,89,10
2.0,5,2,1,2,4,90,11
2.0,5,1,1,3,4,91,12
2.0,5,2,1,2,4,92,13
2.0,5,-2,1,3,1,93,14
3.0,1,1,0,2,3,0,1
3.0,1,0,0,2,2,1,2
3.0,1,1,1,3,4,2,1
3.0,1,2,1,2,4,3,2
3.0,1,1,1,3,4,4,3
3.0,1,3,2,7,10,5,1
3.0,1,4,2,7,11,6,2
3.0,1,3,2,6,9,7,3
3.0,1,1,0,2,3,8,1
3.0,1,0,0,2,2,9,2
3.0,1,1,0,2,3,10,3
3.0,2,1,0,2,3,20,4
3.0,2,0,0,2,2,21,5
3.0,2,1,0,2,3,22,6
3.0,2,3,2,6,9,23,1
3.0,2,2,2,7,9,24,2
3.0,2,4,2,6,10,25,3
3.0,2,3,2,8,11,26,4
3.0,2,3,2,6,9,27,5
3.0,2,2,1,2,4,28,1
3.0,2,-4,2,6,2,29,1
3.0,3,1,1,2,3,40,1
3.0,3,0,2,6,6,41,1
3.0,3,0,1,3,3,42,1
3.0,3,0,1,3,3,43,2
3.0,3,1,1,2,3,44,3
3.0,3,1,1,2,3,45,4
3.0,3,0,2,6,6,46,1
3.0,3,4,2,7,11,47,2
3.0,3,1,1,3,4,48,1
3.0,3,1,1,3,4,49,2
3.0,3,3,2,7,10,50,1
3.0,4,0,0,2,2,60,1
3.0,4,0,0,2,2,61,2
3.0,4,0,0,2,2,62,3
3.0,4,0,2,7,7,63,1
3.0,4,0,2,6,6,64,2
3.0,4,0,2,7,7,65,3
3.0,4,0,2,7,7,66,4
3.0,4,3,2,7,10,67,5
3.0,4,4,2,8,12,68,6
3.0,4,1,0,2,3,69,1
3.0,5,1,1,3,4,80,1
3.0,5,2,1,2,4,81,2
3.0,5,1,1,3,4,82,3
3.0,5,2,1,2,4,83,4
3.0,5,2,1,2,4,84,5
3.0,5,2,1,2,4,85,6
3.0,5,2,1,2,4,86,7
3.0,5,2,1,2,4,87,8
3.0,5,2,1,2,4,88,9
3.0,5,2,1,2,4,89,10
3.0,5,2,1,2,4,90,11
3.0,5,2,1,2,4,91,12
3.0,5,-1,1,2,1,92,13
5.0,1,-1,0,2,1,0,1
5.0,1,0,0,2,2,1,2
5.0,1,-2,1,3,1,2,1
5.0,1,1,1,3,4,3,2
5.0,1,2,1,3,5,4,3
5.0,1,2,2,6,8,5,1
5.0,1,3,2,7,10,6,2
5.0,1,4,2,6,10,7,3
5.0,1,4,0,2,6,8,1
5.0,1,3,0,2,5,9,2
5.0,1,0,0,2,2,10,3
5.0,2,1,0,2,3,20,4
5.0,2,1,0,2,3,21,5
5.0,2,1,0,2,3,22,6
5.0,2,3,2,8,11,23,1
5.0,2,3,2,8,11,24,2
5.0,2,5,2,7,12,25,3
5.0,2,3,2,7,10,26,4
5.0,2,4,2,6,10,27,5
5.0,2,1,1,2,3,28,1
5.0,3,1,1,2,3,40,2
5.0,3,0,2,8,8,41,1
5.0,3,1,1,2,3,42,1
5.0,3,0,1,3,3,43,2
5.0,3,1,1,2,3,44,3
5.0,3,1,1,2,3,45,4
5.0,3,0,2,7,7,46,1
5.0,3,0,2,7,7,47,2
5.0,3,2,1,2,4,48,1
5.0,3,1,1,3,4,49,2
5.0,3,3,2,7,10,50,1
5.0,4,0,0,2,2,60,1
5.0,4,1,0,2,3,61,2
5.0,4,1,0,2,3,62,3
5.0,4,1,2,6,7,63,1
5.0,4,3,2,5,8,64,2
5.0,4,2,2,7,9,65,3
5.0,4,3,2,7,10,66,4
5.0,4,2,2,6,8,67,5
5.0,4,4,2,7,11,68,6
5.0,4,-1,0,2,1,69,1
5.0,5,1,1,2,3,80,1
5.0,5,1,1,2,3,81,2
5.0,5,1,1,2,3,82,3
5.0,5,1,1,2,3,83,4
5.0,5,1,1,2,3,84,5
5.0,5,1,1,2,3,85,6
5.0,5,1,1,2,3,86,7
5.0,5,1,1,2,3,87,8
5.0,5,1,1,2,3,88,9
5.0,5,1,1,2,3,89,10
5.0,5,2,1,2,4,90,11
5.0,5,2,1,2,4,91,12
5.0,5,2,1,2,4,92,13
5.0,5,0,1,2,2,93,14
8.0,1,-1,0,2,1,0,1
8.0,1,0,0,2,2,1,2
8.0,1,2,1,2,4,2,1
8.0,1,1,1,2,3,3,2
8.0,1,1,1,2,3,4,3
8.0,1,3,2,8,11,5,1
8.0,1,3,2,7,10,6,2
8.0,1,2,2,6,8,7,3
8.0,1,0,0,2,2,8,1
8.0,1,0,0,2,2,9,2
8.0,1,0,0,2,2,10,3
8.0,1,0,0,2,2,11,4
8.0,2,0,0,2,2,20,5
8.0,2,0,0,2,2,21,6
8.0,2,0,0,2,2,22,7
8.0,2,2,2,7,9,23,1
8.0,2,3,2,8,11,24,2
8.0,2,3,2,6,9,25,3
8.0,2,3,2,7,10,26,4
8.0,2,5,2,6,11,27,5
8.0,2,2,1,2,4,28,1
8.0,2,-4,2,6,2,29,1
8.0,3,0,1,3,3,40,1
8.0,3,0,2,6,6,41,1
8.0,3,1,1,2,3,42,1
8.0,3,1,1,2,3,43,2
8.0,3,1,1,2,3,44,3
8.0,3,0,1,3,3,45,4
8.0,3,2,2,6,8,46,1
8.0,3,3,2,8,11,47,2
8.0,3,2,1,2,4,48,1
8.0,3,1,1,3,4,49,2
8.0,3,2,2,7,9,50,1
8.0,4,0,0,2,2,60,1
8.0,4,0,0,2,2,61,2
8.0,4,0,0,2,2,62,3
8.0,4,0,2,6,6,63,1
8.0,4,0,2,6,6,64,2
8.0,4,0,2,7,7,65,3
8.0,4,4,2,6,10,66,4
8.0,4,4,2,6,10,67,5
8.0,4,4,2,6,10,68,6
8.0,4,1,0,2,3,69,1
8.0,5,2,1,2,4,80,1
8.0,5,1,1,3,4,81,2
8.0,5,2,1,2,4,82,3
8.0,5,2,1,2,4,83,4
8.0,5,1,1,3,4,84,5
8.0,5,1,1,3,4,85,6
8.0,5,2,1,2,4,86,7
8.0,5,2,1,2,4,87,8
8.0,5,2,1,2,4,88,9
8.0,5,1,1,3,4,89,10
8.0,5,2,1,2,4,90,11
8.0,5,1,1,3,4,91,12
8.0,5,-2,1,3,1,92,13
9.0,1,-1,0,2,1,0,1
9.0,1,-1,0,2,1,1,2
9.0,1,2,1,2,4,2,1
9.0,1,1,1,3,4,3,2
9.0,1,0,1,3,3,4,3
9.0,1,3,2,7,10,5,1
9.0,1,3,2,6,9,6,2
9.0,1,4,2,7,11,7,3
9.0,1,2,0,2,4,8,1
9.0,1,3,0,2,5,9,2
9.0,1,1,0,2,3,10,3
9.0,2,0,0,2,2,20,4
9.0,2,1,0,2,3,21,5
9.0,2,1,0,2,3,22,6
9.0,2,3,2,8,11,23,1
9.0,2,3,2,7,10,24,2
9.0,2,3,2,7,10,25,3
9.0,2,3,2,8,11,26,4
9.0,2,2,2,6,8,27,5
9.0,2,2,1,2,4,28,1
9.0,3,2,1,2,4,40,2
9.0,3,2,2,8,10,41,1
9.0,3,2,1,2,4,42,1
9.0,3,2,1,2,4,43,2
9.0,3,2,1,2,4,44,3
9.0,3,2,1,2,4,45,4
9.0,3,1,2,8,9,46,1
9.0,3,3,2,6,9,47,2
9.0,3,0,1,3,3,48,1
9.0,3,1,1,2,3,49,2
9.0,3,-5,2,8,3,50,1
9.0,4,0,0,2,2,60,1
9.0,4,0,0,2,2,61,2
9.0,4,0,0,2,2,62,3
9.0,4,0,2,6,6,63,1
9.0,4,0,2,7,7,64,2
9.0,4,0,2,6,6,65,3
9.0,4,0,2,6,6,66,4
9.0,4,0,2,6,6,67,5
9.0,4,3,2,7,10,68,6
9.0,4,1,0,2,3,69,1
9.0,4,0,0,2,2,70,2
9.0,4,-5,2,6,1,71,1
9.0,5,1,1,2,3,80,1
9.0,5,1,1,2,3,81,2
9.0,5,1,1,2,3,82,3
9.0,5,1,1,2,3,83,4
9.0,5,1,1,2,3,84,5
9.0,5,0,1,3,3,85,6
9.0,5,1,1,2,3,86,7
9.0,5,1,1,2,3,87,8
9.0,5,2,1,2,4,88,9
9.0,5,2,1,2,4,89,10
9.0,5,2,1,2,4,90,11
9.0,5,2,1,3,5,91,12
9.0,5,2,1,2,4,92,13
10.0,1,1,0,2,3,0,1
10.0,1,1,0,2,3,1,2
10.0,1,1,1,3,4,2,1
10.0,1,1,1,3,4,3,2
10.0,1,1,1,3,4,4,3
10.0,1,2,2,6,8,5,1
10.0,1,4,2,7,11,6,2
10.0,1,4,2,7,11,7,3
10.0,1,1,0,2,3,8,1
10.0,1,0,0,2,2,9,2
10.0,1,1,0,2,3,10,3
10.0,2,1,0,2,3,20,4
10.0,2,1,0,2,3,21,5
10.0,2,1,0,2,3,22,6
10.0,2,3,2,7,10,23,1
10.0,2,1,2,8,9,24,2
10.0,2,4,2,7,11,25,3
10.0,2,3,2,7,10,26,4
10.0,2,4,2,6,10,27,5
10.0,2,2,1,2,4,28,1
10.0,3,2,1,2,4,40,2
10.0,3,4,2,5,9,41,1
10.0,3,2,1,3,5,42,1
10.0,3,2,1,2,4,43,2
10.0,3,2,1,2,4,44,3
10.0,3,2,1,2,4,45,4
10.0,3,3,2,7,10,46,1
10.0,3,3,2,6,9,47,2
10.0,3,2,1,2,4,48,1
10.0,3,1,1,3,4,49,2
10.0,4,1,0,2,3,60,1
10.0,4,1,0,2,3,61,2
10.0,4,0,0,2,2,62,3
10.0,4,4,2,6,10,63,1
10.0,4,3,2,7,10,64,2
10.0,4,3,2,8,11,65,3
10.0,4,3,2,6,9,66,4
10.0,4,2,2,7,9,67,5
10.0,4,3,2,6,9,68,6
10.0,5,2,1,2,4,80,1
10.0,5,1,1,3,4,81,2
10.0,5,2,1,2,4,82,3
10.0,5,2,1,2,4,83,4
10.0,5,1,1,3,4,84,5
10.0,5,1,1,2,3,85,6
10.0,5,0,1,3,3,86,7
10.0,5,0,1,3,3,87,8
10.0,5,0,1,3,3,88,9
10.0,5,1,1,2,3,89,10
10.0,5,1,1,2,3,90,11
10.0,5,0,1,3,3,91,12
10.0,5,0,1,3,3,92,13
13.0,1,-1,0,2,1,0,1
13.0,1,0,0,2,2,1,2
13.0,1,-2,1,3,1,2,1
13.0,1,1,1,3,4,3,2
13.0,1,1,1,3,4,4,3
13.0,1,3,2,6,9,5,1
13.0,1,3,2,6,9,6,2
13.0,1,3,2,6,9,7,3
13.0,1,1,0,2,3,8,1
13.0,1,2,0,2,4,9,2
13.0,1,1,0,2,3,10,3
13.0,1,1,0,2,3,11,4
13.0,2,0,0,2,2,20,5
13.0,2,1,0,2,3,21,6
13.0,2,1,0,2,3,22,7
13.0,2,3,2,8,11,23,1
13.0,2,3,2,7,10,24,2
13.0,2,2,2,7,9,25,3
13.0,2,3,2,7,10,26,4
13.0,2,3,2,7,10,27,5
13.0,2,2,1,2,4,28,1
13.0,3,1,1,3,4,40,2
13.0,3,4,2,7,11,41,1
13.0,3,1,1,3,4,42,1
13.0,3,1,1,3,4,43,2
13.0,3,1,1,3,4,44,3
13.0,3,1,1,3,4,45,4
13.0,3,4,2,6,10,46,1
13.0,3,3,2,7,10,47,2
13.0,3,2,1,2,4,48,1
13.0,3,1,1,3,4,49,2
13.0,4,1,0,2,3,60,1
13.0,4,1,0,2,3,61,2
13.0,4,1,0,2,3,62,3
13.0,4,4,2,6,10,63,1
13.0,4,3,2,6,9,64,2
13.0,4,3,2,5,8,65,3
13.0,4,4,2,7,11,66,4
13.0,4,2,2,6,8,67,5
13.0,4,4,2,5,9,68,6
13.0,5,2,1,2,4,80,1
13.0,5,2,1,2,4,81,2
13.0,5,2,1,2,4,82,3
13.0,5,1,1,3,4,83,4
13.0,5,1,1,3,4,84,5
13.0,5,1,1,3,4,85,6
13.0,5,2,1,2,4,86,7
13.0,5,1,1,3,4,87,8
13.0,5,2,1,2,4,88,9
13.0,5,2,1,2,4,89,10
13.0,5,1,1,3,4,90,11
13.0,5,2,1,2,4,91,12
13.0,5,-2,1,3,1,92,13
15.0,1,0,0,2,2,0,1
15.0,1,0,0,2,2,1,2
15.0,1,1,1,3,4,2,1
15.0,1,1,1,3,4,3,2
15.0,1,2,1,2,4,4,3
15.0,1,3,2,7,10,5,1
15.0,1,3,2,6,9,6,2
15.0,1,3,2,7,10,7,3
15.0,1,1,0,2,3,8,1
15.0,1,2,0,2,4,9,2
15.0,1,1,0,2,3,10,3
15.0,2,0,0,2,2,20,4
15.0,2,0,0,2,2,21,5
15.0,2,1,0,2,3,22,6
15.0,2,2,2,7,9,23,1
15.0,2,3,2,7,10,24,2
15.0,2,3,2,7,10,25,3
15.0,2,3,2,6,9,26,4
15.0,2,3,2,6,9,27,5
15.0,2,2,1,2,4,28,1
15.0,2,-2,2,6,4,29,1
15.0,3,0,1,3,3,40,1
15.0,3,0,2,6,6,41,1
15.0,3,1,1,2,3,42,1
15.0,3,1,1,2,3,43,2
15.0,3,1,1,2,3,44,3
15.0,3,1,1,2,3,45,4
15.0,3,0,2,7,7,46,1
15.0,3,0,2,7,7,47,2
15.0,3,2,1,2,4,48,1
15.0,3,2,1,2,4,49,2
15.0,3,3,2,6,9,50,1
15.0,3,-6,2,7,1,51,2
15.0,4,0,0,2,2,60,1
15.0,4,0,0,2,2,61,2
15.0,4,0,0,2,2,62,3
15.0,4,0,2,7,7,63,1
15.0,4,0,2,6,6,64,2
15.0,4,0,2,7,7,65,3
15.0,4,3,2,7,10,66,4
15.0,4,2,2,6,8,67,5
15.0,4,2,2,6,8,68,6
15.0,4,0,0,2,2,69,1
15.0,4,1,0,2,3,70,2
15.0,5,2,1,2,4,80,1
15.0,5,2,1,2,4,81,2
15.0,5,1,1,3,4,82,3
15.0,5,2,1,2,4,83,4
15.0,5,2,1,2,4,84,5
15.0,5,2,1,2,4,85,6
15.0,5,2,1,2,4,86,7
15.0,5,2,1,2,4,87,8
15.0,5,2,1,2,4,88,9
15.0,5,2,1,2,4,89,10
15.0,5,2,1,2,4,90,11
15.0,5,2,1,2,4,91,12
15.0,5,-2,1,3,1,92,13
18.0,1,1,0,2,3,0,1
18.0,1,0,0,2,2,1,2
18.0,1,0,1,3,3,2,1
18.0,1,1,1,3,4,3,2
18.0,1,1,1,2,3,4,3
18.0,1,3,2,7,10,5,1
18.0,1,2,2,7,9,6,2
18.0,1,3,2,7,10,7,3
18.0,1,1,0,2,3,8,1
18.0,1,1,0,2,3,9,2
18.0,1,1,0,2,3,10,3
18.0,2,1,0,2,3,20,4
18.0,2,1,0,2,3,21,5
18.0,2,0,0,2,2,22,6
18.0,2,3,2,6,9,23,1
18.0,2,3,2,7,10,24,2
18.0,2,0,2,7,7,25,3
18.0,2,3,2,7,10,26,4
18.0,2,3,2,6,9,27,5
18.0,2,1,1,2,3,28,1
18.0,2,0,2,6,6,29,1
18.0,3,2,1,2,4,40,1
18.0,3,4,2,6,10,41,1
18.0,3,2,1,2,4,42,1
18.0,3,2,1,2,4,43,2
18.0,3,1,1,3,4,44,3
18.0,3,1,1,3,4,45,4
18.0,3,3,2,7,10,46,1
18.0,3,4,2,8,12,47,2
18.0,3,0,1,3,3,48,1
18.0,3,2,1,2,4,49,2
18.0,4,0,0,2,2,60,1
18.0,4,1,0,2,3,61,2
18.0,4,0,0,2,2,62,3
18.0,4,0,2,6,6,63,1
18.0,4,3,2,7,10,64,2
18.0,4,2,2,7,9,65,3
18.0,4,6,2,6,12,66,4
18.0,4,4,2,7,11,67,5
18.0,4,4,2,6,10,68,6
18.0,5,2,1,2,4,80,1
18.0,5,2,1,2,4,81,2
18.0,5,2,1,2,4,82,3
18.0,5,2,1,2,4,83,4
18.0,5,2,1,2,4,84,5
18.0,5,2,1,2,4,85,6
18.0,5,2,1,2,4,86,7
18.0,5,2,1,2,4,87,8
18.0,5,2,1,2,4,88,9
18.0,5,2,1,2,4,89,10
18.0,5,2,1,2,4,90,11
18.0,5,2,1,2,4,91,12
18.0,5,-1,1,2,1,92,13
19.0,1,-1,0,2,1,0,1
19.0,1,-1,0,2,1,1,2
19.0,1,-2,1,3,1,2,1
19.0,1,1,1,3,4,3,2
19.0,1,1,1,3,4,4,3
19.0,1,3,2,8,11,5,1
19.0,1,4,2,7,11,6,2
19.0,1,4,2,5,9,7,3
19.0,1,1,0,2,3,8,1
19.0,1,1,0,2,3,9,2
19.0,1,1,0,2,3,10,3
19.0,1,0,0,2,2,11,4
19.0,2,0,0,2,2,20,5
19.0,2,0,0,2,2,21,6
19.0,2,0,0,2,2,22,7
19.0,2,0,2,7,7,23,1
19.0,2,3,2,6,9,24,2
19.0,2,2,2,6,8,25,3
19.0,2,1,2,6,7,26,4
19.0,2,0,2,6,6,27,5
19.0,2,1,1,3,4,28,1
19.0,2,3,2,6,9,29,1
19.0,2,-5,2,6,1,30,2
19.0,3,1,1,2,3,40,1
19.0,3,0,2,6,6,41,1
19.0,3,1,1,2,3,42,1
19.0,3,1,1,2,3,43,2
19.0,3,0,1,3,3,44,3
19.0,3,1,1,2,3,45,4
19.0,3,3,2,6,9,46,1
19.0,3,3,2,7,10,47,2
19.0,3,1,1,3,4,48,1
19.0,3,2,1,2,4,49,2
19.0,3,1,2,6,7,50,1
19.0,4,1,0,2,3,60,1
19.0,4,0,0,2,2,61,2
19.0,4,1,0,2,3,62,3
19.0,4,4,2,8,12,63,1
19.0,4,4,2,6,10,64,2
19.0,4,3,2,6,9,65,3
19.0,4,4,2,5,9,66,4
19.0,4,3,2,7,10,67,5
19.0,4,1,2,7,8,68,6
19.0,5,1,1,2,3,80,1
19.0,5,1,1,2,3,81,2
19.0,5,0,1,3,3,82,3
19.0,5,1,1,2,3,83,4
19.0,5,1,1,2,3,84,5
19.0,5,0,1,3,3,85,6
19.0,5,1,1,2,3,86,7
19.0,5,2,1,2,4,87,8
19.0,5,2,1,2,4,88,9
19.0,5,2,1,2,4,89,10
19.0,5,2,1,2,4,90,11
19.0,5,2,1,2,4,91,12
19.0,5,2,1,2,4,92,13
21.0,1,0,0,2,2,0,1
21.0,1,0,0,2,2,1,2
21.0,1,1,1,3,4,2,1
21.0,1,1,1,3,4,3,2
21.0,1,1,1,3,4,4,3
21.0,1,3,2,7,10,5,1
21.0,1,4,2,6,10,6,2
21.0,1,3,2,9,12,7,3
21.0,1,1,0,2,3,8,1
21.0,1,1,0,2,3,9,2
21.0,1,0,0,2,2,10,3
21.0,2,0,0,2,2,20,4
21.0,2,1,0,2,3,21,5
21.0,2,1,0,2,3,22,6
21.0,2,4,2,7,11,23,1
21.0,2,3,2,7,10,24,2
21.0,2,4,2,6,10,25,3
21.0,2,3,2,6,9,26,4
21.0,2,3,2,6,9,27,5
21.0,2,2,1,2,4,28,1
21.0,2,-5,2,6,1,29,1
21.0,3,1,1,2,3,40,1
21.0,3,0,2,7,7,41,1
21.0,3,1,1,2,3,42,1
21.0,3,0,1,3,3,43,2
21.0,3,1,1,2,3,44,3
21.0,3,1,1,2,3,45,4
21.0,3,0,2,6,6,46,1
21.0,3,4,2,6,10,47,2
21.0,3,2,1,2,4,48,1
21.0,3,2,1,2,4,49,2
21.0,3,5,2,6,11,50,1
21.0,4,0,0,2,2,60,1
21.0,4,0,0,2,2,61,2
21.0,4,1,0,2,3,62,3
21.0,4,3,2,7,10,63,1
21.0,4,4,2,7,11,64,2
21.0,4,4,2,6,10,65,3
21.0,4,2,2,9,11,66,4
21.0,4,4,2,5,9,67,5
21.0,4,2,2,6,8,68,6
21.0,5,1,1,2,3,80,1
21.0,5,1,1,2,3,81,2
21.0,5,1,1,2,3,82,3
21.0,5,0,1,3,3,83,4
21.0,5,1,1,2,3,84,5
21.0,5,0,1,3,3,85,6
21.0,5,1,1,2,3,86,7
21.0,5,1,1,2,3,87,8
21.0,5,1,1,2,3,88,9
21.0,5,2,1,2,4,89,10
21.0,5,2,1,2,4,90,11
21.0,5,2,1,2,4,91,12
21.0,5,2,1,2,4,92,13
21.0,5,-2,1,3,1,93,14
22.0,1,1,0,2,3,0,1
22.0,1,1,0,2,3,1,2
22.0,1,2,1,3,5,2,1
22.0,1,1,1,3,4,3,2
22.0,1,1,1,3,4,4,3
22.0,1,3,2,8,11,5,1
22.0,1,3,2,7,10,6,2
22.0,1,3,2,7,10,7,3
22.0,1,1,0,2,3,8,1
22.0,1,1,0,2,3,9,2
22.0,1,-1,0,2,1,10,3
22.0,2,0,0,2,2,20,4
22.0,2,0,0,2,2,21,5
22.0,2,0,0,2,2,22,6
22.0,2,1,2,6,7,23,1
22.0,2,2,2,7,9,24,2
22.0,2,2,2,7,9,25,3
22.0,2,2,2,7,9,26,4
22.0,2,4,2,8,12,27,5
22.0,2,1,1,3,4,28,1
22.0,2,-1,2,7,6,29,1
22.0,3,1,1,2,3,40,1
22.0,3,1,2,6,7,41,1
22.0,3,1,1,2,3,42,1
22.0,3,1,1,2,3,43,2
22.0,3,0,1,3,3,44,3
22.0,3,1,1,2,3,45,4
22.0,3,0,2,7,7,46,1
22.0,3,1,2,7,8,47,2
22.0,3,2,1,2,4,48,1
22.0,3,2,1,2,4,49,2
22.0,3,4,2,6,10,50,1
22.0,4,1,0,2,3,60,1
22.0,4,1,0,2,3,61,2
22.0,4,0,0,2,2,62,3
22.0,4,3,2,6,9,63,1
22.0,4,4,2,6,10,64,2
22.0,4,4,2,6,10,65,3
22.0,4,3,2,7,10,66,4
22.0,4,3,2,7,10,67,5
22.0,4,2,2,7,9,68,6
22.0,5,1,1,2,3,80,1
22.0,5,1,1,2,3,81,2
22.0,5,1,1,2,3,82,3
22.0,5,1,1,2,3,83,4
22.0,5,1,1,2,3,84,5
22.0,5,1,1,2,3,85,6
22.0,5,1,1,2,3,86,7
22.0,5,1,1,2,3,87,8
22.0,5,1,1,2,3,88,9
22.0,5,2,1,2,4,89,10
22.0,5,2,1,2,4,90,11
22.0,5,2,1,2,4,91,12
22.0,5,2,1,2,4,92,13
22.0,5,-1,1,2,1,93,14
23.0,1,1,0,2,3,0,1
23.0,1,1,0,2,3,1,2
23.0,1,2,1,3,5,2,1
23.0,1,2,1,3,5,3,2
23.0,1,1,1,3,4,4,3
23.0,1,3,2,7,10,5,1
23.0,1,3,2,7,10,6,2
23.0,1,4,2,6,10,7,3
23.0,1,1,0,2,3,8,1
23.0,1,1,0,2,3,9,2
23.0,1,-1,0,2,1,10,3
23.0,2,0,0,2,2,20,4
23.0,2,0,0,2,2,21,5
23.0,2,0,0,2,2,22,6
23.0,2,3,2,7,10,23,1
23.0,2,3,2,7,10,24,2
23.0,2,0,2,7,7,25,3
23.0,2,3,2,7,10,26,4
23.0,2,3,2,7,10,27,5
23.0,2,1,1,2,3,28,1
23.0,2,0,2,6,6,29,1
23.0,3,1,1,2,3,40,1
23.0,3,0,2,8,8,41,1
23.0,3,1,1,2,3,42,1
23.0,3,1,1,2,3,43,2
23.0,3,1,1,2,3,44,3
23.0,3,1,1,2,3,45,4
23.0,3,1,2,5,6,46,1
23.0,3,5,2,5,10,47,2
23.0,3,2,1,2,4,48,1
23.0,3,2,1,2,4,49,2
23.0,3,3,2,6,9,50,1
23.0,4,1,0,2,3,60,1
23.0,4,1,0,2,3,61,2
23.0,4,1,0,2,3,62,3
23.0,4,3,2,7,10,63,1
23.0,4,3,2,6,9,64,2
23.0,4,3,2,6,9,65,3
23.0,4,3,2,7,10,66,4
23.0,4,4,2,8,12,67,5
23.0,4,1,2,6,7,68,6
23.0,5,1,1,2,3,80,1
23.0,5,1,1,2,3,81,2
23.0,5,1,1,2,3,82,3
23.0,5,1,1,2,3,83,4
23.0,5,0,1,3,3,84,5
23.0,5,1,1,2,3,85,6
23.0,5,1,1,2,3,86,7
23.0,5,1,1,2,3,87,8
23.0,5,1,1,2,3,88,9
23.0,5,2,1,2,4,89,10
23.0,5,2,1,2,4,90,11
23.0,5,2,1,2,4,91,12
23.0,5,2,1,2,4,92,13
23.0,5,-2,1,3,1,93,14
25.0,1,1,0,2,3,0,1
25.0,1,1,0,2,3,1,2
25.0,1,1,1,3,4,2,1
25.0,1,1,1,3,4,3,2
25.0,1,1,1,3,4,4,3
25.0,1,3,2,8,11,5,1
25.0,1,3,2,7,10,6,2
25.0,1,4,2,7,11,7,3
25.0,1,0,0,2,2,8,1
25.0,1,0,0,2,2,9,2
25.0,1,1,0,2,3,10,3
25.0,2,1,0,2,3,20,4
25.0,2,1,0,2,3,21,5
25.0,2,4,0,2,6,22,6
25.0,2,3,2,7,10,23,1
25.0,2,3,2,7,10,24,2
25.0,2,3,2,7,10,25,3
25.0,2,3,2,6,9,26,4
25.0,2,4,2,7,11,27,5
25.0,2,1,1,3,4,28,1
25.0,3,2,1,2,4,40,2
25.0,3,4,2,6,10,41,1
25.0,3,2,1,2,4,42,1
25.0,3,2,1,2,4,43,2
25.0,3,2,1,2,4,44,3
25.0,3,1,1,3,4,45,4
25.0,3,3,2,7,10,46,1
25.0,3,3,2,6,9,47,2
25.0,3,2,1,2,4,48,1
25.0,3,2,1,2,4,49,2
25.0,4,1,0,2,3,60,1
25.0,4,1,0,2,3,61,2
25.0,4,1,0,2,3,62,3
25.0,4,3,2,6,9,63,1
25.0,4,3,2,7,10,64,2
25.0,4,2,2,6,8,65,3
25.0,4,3,2,7,10,66,4
25.0,4,2,2,6,8,67,5
25.0,4,3,2,7,10,68,6
25.0,5,1,1,3,4,80,1
25.0,5,2,1,2,4,81,2
25.0,5,2,1,2,4,82,3
25.0,5,2,1,2,4,83,4
25.0,5,1,1,3,4,84,5
25.0,5,2,1,2,4,85,6
25.0,5,2,1,2,4,86,7
25.0,5,1,1,3,4,87,8
25.0,5,2,1,2,4,88,9
25.0,5,1,1,3,4,89,10
25.0,5,2,1,2,4,90,11
25.0,5,2,1,2,4,91,12
25.0,5,-2,1,3,1,92,13
28.0,1,1,0,2,3,0,1
28.0,1,1,0,2,3,1,2
28.0,1,-2,1,3,1,2,1
28.0,1,-1,1,2,1,3,2
28.0,1,1,1,3,4,4,3
28.0,1,3,2,7,10,5,1
28.0,1,4,2,6,10,6,2
28.0,1,4,2,6,10,7,3
28.0,1,0,0,2,2,8,1
28.0,1,1,0,2,3,9,2
28.0,1,1,0,2,3,10,3
28.0,1,1,0,2,3,11,4
28.0,2,1,0,2,3,20,5
28.0,2,1,0,2,3,21,6
28.0,2,1,0,2,3,22,7
28.0,2,2,2,7,9,23,1
28.0,2,2,2,8,10,24,2
28.0,2,3,2,7,10,25,3
28.0,2,4,2,8,12,26,4
28.0,2,3,2,6,9,27,5
28.0,2,2,1,2,4,28,1
28.0,3,2,1,2,4,40,2
28.0,3,3,2,7,10,41,1
28.0,3,1,1,3,4,42,1
28.0,3,2,1,2,4,43,2
28.0,3,2,1,2,4,44,3
28.0,3,2,1,2,4,45,4
28.0,3,3,2,7,10,46,1
28.0,3,3,2,7,10,47,2
28.0,3,2,1,2,4,48,1
28.0,3,2,1,3,5,49,2
28.0,4,1,0,2,3,60,1
28.0,4,1,0,2,3,61,2
28.0,4,1,0,2,3,62,3
28.0,4,3,2,7,10,63,1
28.0,4,2,2,7,9,64,2
28.0,4,2,2,7,9,65,3
28.0,4,4,2,7,11,66,4
28.0,4,3,2,8,11,67,5
28.0,4,1,2,6,7,68,6
28.0,5,1,1,2,3,80,1
28.0,5,1,1,2,3,81,2
28.0,5,1,1,2,3,82,3
28.0,5,1,1,2,3,83,4
28.0,5,1,1,2,3,84,5
28.0,5,0,1,3,3,85,6
28.0,5,1,1,2,3,86,7
28.0,5,1,1,2,3,87,8
28.0,5,3,1,2,5,88,9
28.0,5,2,1,2,4,89,10
28.0,5,2,1,2,4,90,11
28.0,5,2,1,2,4,91,12
28.0,5,2,1,2,4,92,13
29.0,1,1,0,2,3,0,1
29.0,1,1,0,2,3,1,2
29.0,1,1,1,3,4,2,1
29.0,1,1,1,3,4,3,2
29.0,1,1,1,3,4,4,3
29.0,1,2,2,7,9,5,1
29.0,1,2,2,7,9,6,2
29.0,1,2,2,7,9,7,3
29.0,1,1,0,2,3,8,1
29.0,1,0,0,2,2,9,2
29.0,1,1,0,2,3,10,3
29.0,2,0,0,2,2,20,4
29.0,2,1,0,2,3,21,5
29.0,2,1,0,2,3,22,6
29.0,2,2,2,7,9,23,1
29.0,2,3,2,6,9,24,2
29.0,2,2,2,7,9,25,3
29.0,2,3,2,6,9,26,4
29.0,2,5,2,6,11,27,5
29.0,2,1,1,3,4,28,1
29.0,2,-4,2,7,3,29,1
29.0,3,1,1,2,3,40,1
29.0,3,0,2,7,7,41,1
29.0,3,1,1,2,3,42,1
29.0,3,0,1,3,3,43,2
29.0,3,1,1,2,3,44,3
29.0,3,1,1,2,3,45,4
29.0,3,0,2,7,7,46,1
29.0,3,0,2,6,6,47,2
29.0,3,0,1,3,3,48,1
29.0,3,1,1,2,3,49,2
29.0,3,0,2,6,6,50,1
29.0,3,0,2,6,6,51,2
29.0,4,0,0,2,2,60,1
29.0,4,0,0,2,2,61,2
29.0,4,0,0,2,2,62,3
29.0,4,0,2,6,6,63,1
29.0,4,0,2,7,7,64,2
29.0,4,3,2,5,8,65,3
29.0,4,3,2,7,10,66,4
29.0,4,4,2,8,12,67,5
29.0,4,4,2,7,11,68,6
29.0,4,0,0,2,2,69,1
29.0,5,1,1,2,3,80,1
29.0,5,1,1,2,3,81,2
29.0,5,1,1,2,3,82,3
29.0,5,1,1,2,3,83,4
29.0,5,1,1,2,3,84,5
29.0,5,0,1,3,3,85,6
29.0,5,1,1,2,3,86,7
29.0,5,2,1,2,4,87,8
29.0,5,2,1,2,4,88,9
29.0,5,2,1,2,4,89,10
29.0,5,2,1,2,4,90,11
29.0,5,2,1,3,5,91,12
29.0,5,2,1,2,4,92,13
30.0,1,1,0,2,3,0,1
30.0,1,0,0,2,2,1,2
30.0,1,1,1,3,4,2,1
30.0,1,1,1,3,4,3,2
30.0,1,1,1,3,4,4,3
30.0,1,3,2,8,11,5,1
30.0,1,3,2,7,10,6,2
30.0,1,4,2,6,10,7,3
30.0,1,1,0,2,3,8,1
30.0,1,0,0,2,2,9,2
30.0,1,1,0,2,3,10,3
30.0,2,1,0,2,3,20,4
30.0,2,1,0,2,3,21,5
30.0,2,1,0,2,3,22,6
30.0,2,3,2,8,11,23,1
30.0,2,4,2,6,10,24,2
30.0,2,3,2,7,10,25,3
30.0,2,4,2,5,9,26,4
30.0,2,2,2,6,8,27,5
30.0,2,1,1,2,3,28,1
30.0,2,-4,2,6,2,29,1
30.0,3,1,1,2,3,40,1
30.0,3,0,2,7,7,41,1
30.0,3,0,1,3,3,42,1
30.0,3,1,1,2,3,43,2
30.0,3,1,1,2,3,44,3
30.0,3,0,1,3,3,45,4
30.0,3,2,2,6,8,46,1
30.0,3,3,2,7,10,47,2
30.0,3,2,1,2,4,48,1
30.0,3,1,1,3,4,49,2
30.0,3,2,2,7,9,50,1
30.0,4,0,0,2,2,60,1
30.0,4,0,0,2,2,61,2
30.0,4,0,0,2,2,62,3
30.0,4,0,2,7,7,63,1
30.0,4,0,2,6,6,64,2
30.0,4,0,2,6,6,65,3
30.0,4,0,2,7,7,66,4
30.0,4,2,2,6,8,67,5
30.0,4,3,2,7,10,68,6
30.0,4,0,0,2,2,69,1
30.0,4,0,0,2,2,70,2
30.0,5,2,1,2,4,80,1
30.0,5,2,1,2,4,81,2
30.0,5,2,1,2,4,82,3
30.0,5,2,1,2,4,83,4
30.0,5,2,1,2,4,84,5
30.0,5,2,1,2,4,85,6
30.0,5,2,1,2,4,86,7
30.0,5,3,1,2,5,87,8
30.0,5,1,1,3,4,88,9
30.0,5,0,1,3,3,89,10
30.0,5,2,1,2,4,90,11
30.0,5,2,1,2,4,91,12
30.0,5,-2,1,3,1,92,13
31.0,1,0,0,2,2,0,1
31.0,1,1,0,2,3,1,2
31.0,1,3,1,2,5,2,1
31.0,1,2,1,3,5,3,2
31.0,1,0,1,3,3,4,3
31.0,1,1,2,8,9,5,1
31.0,1,0,2,6,6,6,2
31.0,1,3,2,5,8,7,3
31.0,1,1,0,2,3,8,1
31.0,1,1,0,2,3,9,2
31.0,1,1,0,2,3,10,3
31.0,1,0,0,2,2,11,4
31.0,2,1,0,2,3,20,5
31.0,2,1,0,2,3,21,6
31.0,2,0,0,2,2,22,7
31.0,2,-1,2,8,7,23,1
31.0,2,0,2,8,8,24,2
31.0,2,1,2,7,8,25,3
31.0,2,4,2,7,11,26,4
31.0,2,4,2,6,10,27,5
31.0,2,1,1,3,4,28,1
31.0,2,-1,2,7,6,29,1
31.0,3,0,1,3,3,40,1
31.0,3,0,2,7,7,41,1
31.0,3,1,1,2,3,42,1
31.0,3,0,1,3,3,43,2
31.0,3,1,1,2,3,44,3
31.0,3,1,1,2,3,45,4
31.0,3,2,2,6,8,46,1
31.0,3,1,2,7,8,47,2
31.0,3,2,1,2,4,48,1
31.0,3,2,1,2,4,49,2
31.0,3,3,2,6,9,50,1
31.0,4,0,0,2,2,60,1
31.0,4,1,0,2,3,61,2
31.0,4,1,0,2,3,62,3
31.0,4,3,2,7,10,63,1
31.0,4,3,2,7,10,64,2
31.0,4,3,2,7,10,65,3
31.0,4,3,2,6,9,66,4
31.0,4,5,2,6,11,67,5
31.0,4,1,2,7,8,68,6
31.0,5,2,1,2,4,80,1
31.0,5,2,1,2,4,81,2
31.0,5,2,1,2,4,82,3
31.0,5,1,1,3,4,83,4
31.0,5,1,1,2,3,84,5
31.0,5,1,1,2,3,85,6
31.0,5,1,1,2,3,86,7
31.0,5,1,1,2,3,87,8
31.0,5,2,1,2,4,88,9
31.0,5,0,1,3,3,89,10
31.0,5,2,1,2,4,90,11
31.0,5,2,1,2,4,91,12
31.0,5,1,1,3,4,92,13
32.0,1,-1,0,2,1,0,1
32.0,1,-1,0,2,1,1,2
32.0,1,1,1,3,4,2,1
32.0,1,1,1,3,4,3,2
32.0,1,1,1,3,4,4,3
32.0,1,4,2,6,10,5,1
32.0,1,4,2,6,10,6,2
32.0,1,3,2,6,9,7,3
32.0,1,1,0,2,3,8,1
32.0,1,0,0,2,2,9,2
32.0,1,1,0,2,3,10,3
32.0,1,0,0,2,2,11,4
32.0,2,1,0,2,3,20,5
32.0,2,1,0,2,3,21,6
32.0,2,1,0,2,3,22,7
32.0,2,3,2,6,9,23,1
32.0,2,3,2,8,11,24,2
32.0,2,3,2,7,10,25,3
32.0,2,3,2,6,9,26,4
32.0,2,3,2,6,9,27,5
32.0,2,1,1,3,4,28,1
32.0,2,-6,2,7,1,29,1
32.0,3,1,1,2,3,40,1
32.0,3,-1,2,9,8,41,1
32.0,3,1,1,2,3,42,1
32.0,3,1,1,2,3,43,2
32.0,3,0,1,3,3,44,3
32.0,3,1,1,3,4,45,4
32.0,3,3,2,6,9,46,1
32.0,3,3,2,6,9,47,2
32.0,3,1,1,3,4,48,1
32.0,3,1,1,3,4,49,2
32.0,3,1,2,6,7,50,1
32.0,4,0,0,2,2,60,1
32.0,4,0,0,2,2,61,2
32.0,4,0,0,2,2,62,3
32.0,4,0,2,7,7,63,1
32.0,4,0,2,6,6,64,2
32.0,4,0,2,6,6,65,3
32.0,4,1,2,6,7,66,4
32.0,4,3,2,5,8,67,5
32.0,4,3,2,7,10,68,6
32.0,4,1,0,2,3,69,1
32.0,4,1,0,2,3,70,2
32.0,5,2,1,2,4,80,1
32.0,5,1,1,2,3,81,2
32.0,5,1,1,3,4,82,3
32.0,5,1,1,3,4,83,4
32.0,5,2,1,2,4,84,5
32.0,5,2,1,2,4,85,6
32.0,5,2,1,2,4,86,7
32.0,5,2,1,2,4,87,8
32.0,5,2,1,2,4,88,9
32.0,5,2,1,2,4,89,10
32.0,5,2,1,2,4,90,11
32.0,5,2,1,2,4,91,12
32.0,5,0,1,2,2,92,13
33.0,1,-1,0,2,1,0,1
33.0,1,-1,0,2,1,1,2
33.0,1,-2,1,3,1,2,1
33.0,1,1,1,3,4,3,2
33.0,1,1,1,3,4,4,3
33.0,1,3,2,7,10,5,1
33.0,1,3,2,6,9,6,2
33.0,1,2,2,6,8,7,3
33.0,1,4,0,2,6,8,1
33.0,1,1,0,2,3,9,2
33.0,1,1,0,2,3,10,3
33.0,1,1,0,2,3,11,4
33.0,2,0,0,2,2,20,5
33.0,2,0,0,2,2,21,6
33.0,2,2,0,2,4,22,7
33.0,2,2,2,7,9,23,1
33.0,2,3,2,7,10,24,2
33.0,2,2,2,7,9,25,3
33.0,2,3,2,5,8,26,4
33.0,2,2,2,6,8,27,5
33.0,2,2,1,2,4,28,1
33.0,2,-1,2,7,6,29,1
33.0,3,0,1,3,3,40,1
33.0,3,-1,2,7,6,41,1
33.0,3,0,1,3,3,42,1
33.0,3,0,1,3,3,43,2
33.0,3,1,1,2,3,44,3
33.0,3,1,1,2,3,45,4
33.0,3,2,2,7,9,46,1
33.0,3,3,2,7,10,47,2
33.0,3,2,1,2,4,48,1
33.0,3,2,1,2,4,49,2
33.0,3,2,2,7,9,50,1
33.0,4,0,0,2,2,60,1
33.0,4,0,0,2,2,61,2
33.0,4,0,0,2,2,62,3
33.0,4,-1,2,6,5,63,1
33.0,4,0,2,5,5,64,2
33.0,4,-1,2,6,5,65,3
33.0,4,4,2,6,10,66,4
33.0,4,5,2,7,12,67,5
33.0,4,4,2,7,11,68,6
33.0,4,0,0,2,2,69,1
33.0,4,-1,0,2,1,70,2
33.0,5,1,1,2,3,80,1
33.0,5,0,1,3,3,81,2
33.0,5,1,1,2,3,82,3
33.0,5,1,1,2,3,83,4
33.0,5,1,1,2,3,84,5
33.0,5,1,1,3,4,85,6
33.0,5,1,1,2,3,86,7
33.0,5,0,1,3,3,87,8
33.0,5,0,1,3,3,88,9
33.0,5,1,1,3,4,89,10
33.0,5,1,1,3,4,90,11
33.0,5,2,1,2,4,91,12
33.0,5,2,1,3,5,92,13
34.0,1,0,0,2,2,0,1
34.0,1,0,0,2,2,1,2
34.0,1,1,1,3,4,2,1
34.0,1,2,1,2,4,3,2
34.0,1,1,1,3,4,4,3
34.0,1,3,2,6,9,5,1
34.0,1,2,2,8,10,6,2
34.0,1,3,2,6,9,7,3
34.0,1,0,0,2,2,8,1
34.0,1,0,0,2,2,9,2
34.0,1,0,0,2,2,10,3
34.0,1,0,0,2,2,11,4
34.0,2,0,0,2,2,20,5
34.0,2,0,0,2,2,21,6
34.0,2,1,0,2,3,22,7
34.0,2,0,2,7,7,23,1
34.0,2,0,2,6,6,24,2
34.0,2,0,2,6,6,25,3
34.0,2,0,2,7,7,26,4
34.0,2,2,2,6,8,27,5
34.0,2,1,1,2,3,28,1
34.0,2,0,2,6,6,29,1
34.0,2,1,2,6,7,30,2
34.0,3,2,1,2,4,40,1
34.0,3,4,2,6,10,41,1
34.0,3,2,1,2,4,42,1
34.0,3,2,1,2,4,43,2
34.0,3,2,1,2,4,44,3
34.0,3,1,1,3,4,45,4
34.0,3,3,2,6,9,46,1
34.0,3,2,2,8,10,47,2
34.0,3,2,1,2,4,48,1
34.0,3,2,1,2,4,49,2
34.0,4,1,0,2,3,60,1
34.0,4,1,0,2,3,61,2
34.0,4,1,0,2,3,62,3
34.0,4,3,2,5,8,63,1
34.0,4,4,2,6,10,64,2
34.0,4,4,2,6,10,65,3
34.0,4,4,2,7,11,66,4
34.0,4,4,2,7,11,67,5
34.0,4,1,2,6,7,68,6
34.0,5,1,1,2,3,80,1
34.0,5,1,1,2,3,81,2
34.0,5,1,1,2,3,82,3
34.0,5,1,1,2,3,83,4
34.0,5,1,1,2,3,84,5
34.0,5,1,1,2,3,85,6
34.0,5,1,1,2,3,86,7
34.0,5,1,1,2,3,87,8
34.0,5,1,1,2,3,88,9
34.0,5,1,1,2,3,89,10
34.0,5,2,1,2,4,90,11
34.0,5,1,1,3,4,91,12
34.0,5,2,1,2,4,92,13
34.0,5,0,1,2,2,93,14
37.0,1,1,0,2,3,0,1
37.0,1,0,0,2,2,1,2
37.0,1,1,1,3,4,2,1
37.0,1,1,1,3,4,3,2
37.0,1,1,1,3,4,4,3
37.0,1,3,2,6,9,5,1
37.0,1,3,2,7,10,6,2
37.0,1,3,2,6,9,7,3
37.0,1,0,0,2,2,8,1
37.0,1,1,0,2,3,9,2
37.0,1,0,0,2,2,10,3
37.0,1,-1,0,2,1,11,4
37.0,2,0,0,2,2,20,5
37.0,2,0,0,2,2,21,6
37.0,2,0,0,2,2,22,7
37.0,2,0,2,7,7,23,1
37.0,2,3,2,7,10,24,2
37.0,2,3,2,5,8,25,3
37.0,2,3,2,7,10,26,4
37.0,2,3,2,6,9,27,5
37.0,2,2,1,2,4,28,1
37.0,2,1,2,7,8,29,1
37.0,3,1,1,2,3,40,1
37.0,3,0,2,6,6,41,1
37.0,3,1,1,2,3,42,1
37.0,3,0,1,3,3,43,2
37.0,3,1,1,2,3,44,3
37.0,3,1,1,2,3,45,4
37.0,3,3,2,6,9,46,1
37.0,3,3,2,6,9,47,2
37.0,3,2,1,2,4,48,1
37.0,3,2,1,2,4,49,2
37.0,3,3,2,7,10,50,1
37.0,4,1,0,2,3,60,1
37.0,4,1,0,2,3,61,2
37.0,4,1,0,2,3,62,3
37.0,4,4,2,5,9,63,1
37.0,4,4,2,7,11,64,2
37.0,4,3,2,7,10,65,3
37.0,4,4,2,6,10,66,4
37.0,4,3,2,6,9,67,5
37.0,4,2,2,6,8,68,6
37.0,5,1,1,2,3,80,1
37.0,5,1,1,2,3,81,2
37.0,5,1,1,2,3,82,3
37.0,5,1,1,2,3,83,4
37.0,5,1,1,2,3,84,5
37.0,5,1,1,2,3,85,6
37.0,5,1,1,2,3,86,7
37.0,5,1,1,2,3,87,8
37.0,5,1,1,2,3,88,9
37.0,5,1,1,3,4,89,10
37.0,5,0,1,3,3,90,11
37.0,5,2,1,2,4,91,12
37.0,5,2,1,2,4,92,13
37.0,5,0,1,2,2,93,14
39.0,1,1,0,2,3,0,1
39.0,1,1,0,2,3,1,2
39.0,1,1,1,3,4,2,1
39.0,1,1,1,3,4,3,2
39.0,1,1,1,3,4,4,3
39.0,1,2,2,7,9,5,1
39.0,1,0,2,6,6,6,2
39.0,1,0,2,5,5,7,3
39.0,1,0,0,2,2,8,1
39.0,1,1,0,2,3,9,2
39.0,1,1,0,2,3,10,3
39.0,1,1,0,2,3,11,4
39.0,2,1,0,2,3,20,5
39.0,2,1,0,2,3,21,6
39.0,2,0,0,2,2,22,7
39.0,2,0,2,6,6,23,1
39.0,2,2,2,7,9,24,2
39.0,2,3,2,6,9,25,3
39.0,2,3,2,5,8,26,4
39.0,2,3,2,7,10,27,5
39.0,2,1,1,3,4,28,1
39.0,2,1,2,7,8,29,1
39.0,3,1,1,2,3,40,1
39.0,3,0,2,7,7,41,1
39.0,3,1,1,2,3,42,1
39.0,3,1,1,2,3,43,2
39.0,3,0,1,3,3,44,3
39.0,3,1,1,2,3,45,4
39.0,3,2,2,7,9,46,1
39.0,3,4,2,6,10,47,2
39.0,3,2,1,2,4,48,1
39.0,3,2,1,2,4,49,2
39.0,3,2,2,6,8,50,1
39.0,4,0,0,2,2,60,1
39.0,4,0,0,2,2,61,2
39.0,4,0,0,2,2,62,3
39.0,4,0,2,7,7,63,1
39.0,4,0,2,6,6,64,2
39.0,4,3,2,6,9,65,3
39.0,4,4,2,7,11,66,4
39.0,4,4,2,6,10,67,5
39.0,4,4,2,6,10,68,6
39.0,4,1,0,2,3,69,1
39.0,5,2,1,2,4,80,1
39.0,5,1,1,3,4,81,2
39.0,5,2,1,2,4,82,3
39.0,5,1,1,3,4,83,4
39.0,5,2,1,2,4,84,5
39.0,5,2,1,2,4,85,6
39.0,5,2,1,2,4,86,7
39.0,5,2,1,2,4,87,8
39.0,5,2,1,2,4,88,9
39.0,5,2,1,2,4,89,10
39.0,5,2,1,2,4,90,11
39.0,5,2,1,2,4,91,12
39.0,5,-1,1,2,1,92,13
40.0,1,1,0,2,3,0,1
40.0,1,1,0,2,3,1,2
40.0,1,2,1,3,5,2,1
40.0,1,2,1,3,5,3,2
40.0,1,1,1,3,4,4,3
40.0,1,2,2,8,10,5,1
40.0,1,3,2,7,10,6,2
40.0,1,3,2,6,9,7,3
40.0,1,0,0,2,2,8,1
40.0,1,1,0,2,3,9,2
40.0,1,0,0,2,2,10,3
40.0,2,1,0,2,3,20,4
40.0,2,1,0,2,3,21,5
40.0,2,0,0,2,2,22,6
40.0,2,4,2,7,11,23,1
40.0,2,3,2,7,10,24,2
40.0,2,2,2,7,9,25,3
40.0,2,0,2,6,6,26,4
40.0,2,-1,2,7,6,27,5
40.0,2,0,1,3,3,28,1
40.0,2,2,2,7,9,29,1
40.0,3,1,1,2,3,40,1
40.0,3,0,2,7,7,41,1
40.0,3,1,1,2,3,42,1
40.0,3,1,1,3,4,43,2
40.0,3,1,1,2,3,44,3
40.0,3,1,1,2,3,45,4
40.0,3,3,2,7,10,46,1
40.0,3,4,2,5,9,47,2
40.0,3,2,1,2,4,48,1
40.0,3,2,1,2,4,49,2
40.0,3,1,2,6,7,50,1
40.0,4,0,0,2,2,60,1
40.0,4,0,0,2,2,61,2
40.0,4,0,0,2,2,62,3
40.0,4,0,2,7,7,63,1
40.0,4,0,2,6,6,64,2
40.0,4,1,2,8,9,65,3
40.0,4,2,2,7,9,66,4
40.0,4,2,2,7,9,67,5
40.0,4,4,2,5,9,68,6
40.0,4,1,0,2,3,69,1
40.0,5,1,1,3,4,80,1
40.0,5,2,1,2,4,81,2
40.0,5,1,1,3,4,82,3
40.0,5,2,1,2,4,83,4
40.0,5,2,1,2,4,84,5
40.0,5,1,1,3,4,85,6
40.0,5,2,1,2,4,86,7
40.0,5,2,1,2,4,87,8
40.0,5,2,1,2,4,88,9
40.0,5,2,1,2,4,89,10
40.0,5,2,1,2,4,90,11
40.0,5,2,1,2,4,91,12
40.0,5,-1,1,2,1,92,13
41.0,1,1,0,2,3,0,1
41.0,1,2,0,2,4,1,2
41.0,1,2,1,3,5,2,1
41.0,1,1,1,3,4,3,2
41.0,1,1,1,3,4,4,3
41.0,1,3,2,6,9,5,1
41.0,1,3,2,7,10,6,2
41.0,1,2,2,8,10,7,3
41.0,1,1,0,2,3,8,1
41.0,1,1,0,2,3,9,2
41.0,1,0,0,2,2,10,3
41.0,2,0,0,2,2,20,4
41.0,2,0,0,2,2,21,5
41.0,2,0,0,2,2,22,6
41.0,2,0,2,7,7,23,1
41.0,2,-1,2,7,6,24,2
41.0,2,0,2,7,7,25,3
41.0,2,3,2,6,9,26,4
41.0,2,2,2,6,8,27,5
41.0,2,2,1,2,4,28,1
41.0,2,3,2,7,10,29,1
41.0,3,2,1,2,4,40,1
41.0,3,4,2,5,9,41,1
41.0,3,2,1,2,4,42,1
41.0,3,2,1,2,4,43,2
41.0,3,2,1,2,4,44,3
41.0,3,2,1,3,5,45,4
41.0,3,4,2,6,10,46,1
41.0,3,2,2,8,10,47,2
41.0,3,2,1,2,4,48,1
41.0,3,2,1,2,4,49,2
41.0,4,1,0,2,3,60,1
41.0,4,1,0,2,3,61,2
41.0,4,1,0,2,3,62,3
41.0,4,3,2,7,10,63,1
41.0,4,3,2,7,10,64,2
41.0,4,3,2,7,10,65,3
41.0,4,2,2,7,9,66,4
41.0,4,2,2,7,9,67,5
41.0,4,3,2,6,9,68,6
41.0,5,2,1,2,4,80,1
41.0,5,2,1,2,4,81,2
41.0,5,2,1,2,4,82,3
41.0,5,2,1,2,4,83,4
41.0,5,1,1,3,4,84,5
41.0,5,2,1,2,4,85,6
41.0,5,2,1,2,4,86,7
41.0,5,2,1,2,4,87,8
41.0,5,2,1,2,4,88,9
41.0,5,2,1,2,4,89,10
41.0,5,1,1,3,4,90,11
41.0,5,1,1,3,4,91,12
41.0,5,-1,1,2,1,92,13
44.0,1,0,0,2,2,0,1
44.0,1,-1,0,2,1,1,2
44.0,1,-2,1,3,1,2,1
44.0,1,2,1,3,5,3,2
44.0,1,1,1,3,4,4,3
44.0,1,-8,2,9,1,5,1
44.0,1,3,2,7,10,6,2
44.0,1,3,2,7,10,7,3
44.0,1,1,0,2,3,8,1
44.0,1,0,0,2,2,9,2
44.0,1,1,0,2,3,10,3
44.0,1,1,0,2,3,11,4
44.0,1,1,0,2,3,12,5
44.0,2,1,0,2,3,20,6
44.0,2,1,0,2,3,21,7
44.0,2,1,0,2,3,22,8
44.0,2,3,2,7,10,23,1
44.0,2,3,2,7,10,24,2
44.0,2,2,2,8,10,25,3
44.0,2,0,2,7,7,26,4
44.0,2,1,2,7,8,27,5
44.0,2,2,1,2,4,28,1
44.0,2,-2,2,6,4,29,1
44.0,3,0,1,3,3,40,1
44.0,3,-1,2,7,6,41,1
44.0,3,1,1,2,3,42,1
44.0,3,1,1,2,3,43,2
44.0,3,1,1,2,3,44,3
44.0,3,1,1,2,3,45,4
44.0,3,0,2,7,7,46,1
44.0,3,2,2,7,9,47,2
44.0,3,2,1,2,4,48,1
44.0,3,2,1,2,4,49,2
44.0,3,3,2,6,9,50,1
44.0,4,1,0,2,3,60,1
44.0,4,1,0,2,3,61,2
44.0,4,0,0,2,2,62,3
44.0,4,3,2,6,9,63,1
44.0,4,4,2,7,11,64,2
44.0,4,3,2,6,9,65,3
44.0,4,3,2,6,9,66,4
44.0,4,4,2,7,11,67,5
44.0,4,3,2,6,9,68,6
44.0,5,1,1,2,3,80,1
44.0,5,0,1,3,3,81,2
44.0,5,1,1,2,3,82,3
44.0,5,1,1,2,3,83,4
44.0,5,1,1,2,3,84,5
44.0,5,1,1,2,3,85,6
44.0,5,1,1,2,3,86,7
44.0,5,1,1,2,3,87,8
44.0,5,0,1,3,3,88,9
44.0,5,1,1,2,3,89,10
44.0,5,2,1,2,4,90,11
44.0,5,2,1,2,4,91,12
44.0,5,2,1,2,4,92,13
44.0,5,0,1,2,2,93,14
45.0,1,1,0,2,3,0,1
45.0,1,1,0,2,3,1,2
45.0,1,-2,1,3,1,2,1
45.0,1,-2,1,3,1,3,2
45.0,1,-2,1,3,1,4,3
45.0,1,-6,2,7,1,5,1
45.0,1,3,2,7,10,6,2
45.0,1,2,2,7,9,7,3
45.0,1,0,0,2,2,8,1
45.0,1,0,0,2,2,9,2
45.0,1,0,0,2,2,10,3
45.0,1,1,0,2,3,11,4
45.0,1,0,0,2,2,12,5
45.0,1,-3,2,7,4,13,1
45.0,2,0,0,2,2,20,1
45.0,2,0,0,2,2,21,2
45.0,2,0,0,2,2,22,3
45.0,2,0,2,7,7,23,1
45.0,2,-1,2,7,6,24,2
45.0,2,0,2,7,7,25,3
45.0,2,3,2,6,9,26,4
45.0,2,4,2,6,10,27,5
45.0,2,1,1,3,4,28,1
45.0,2,4,2,5,9,29,1
45.0,3,2,1,2,4,40,1
45.0,3,4,2,6,10,41,1
45.0,3,1,1,3,4,42,1
45.0,3,2,1,2,4,43,2
45.0,3,2,1,2,4,44,3
45.0,3,2,1,2,4,45,4
45.0,3,4,2,6,10,46,1
45.0,3,3,2,7,10,47,2
45.0,3,2,1,2,4,48,1
45.0,3,2,1,2,4,49,2
45.0,4,1,0,2,3,60,1
45.0,4,1,0,2,3,61,2
45.0,4,0,0,2,2,62,3
45.0,4,3,2,6,9,63,1
45.0,4,3,2,5,8,64,2
45.0,4,3,2,7,10,65,3
45.0,4,2,2,8,10,66,4
45.0,4,5,2,6,11,67,5
45.0,4,4,2,6,10,68,6
45.0,5,2,1,2,4,80,1
45.0,5,2,1,2,4,81,2
45.0,5,2,1,2,4,82,3
45.0,5,2,1,2,4,83,4
45.0,5,2,1,2,4,84,5
45.0,5,2,1,2,4,85,6
45.0,5,2,1,2,4,86,7
45.0,5,2,1,2,4,87,8
45.0,5,2,1,2,4,88,9
45.0,5,2,1,2,4,89,10
45.0,5,2,1,2,4,90,11
45.0,5,1,1,3,4,91,12
45.0,5,-2,1,3,1,92,13
46.0,1,-1,0,2,1,0,1
46.0,1,-1,0,2,1,1,2
46.0,1,-2,1,3,1,2,1
46.0,1,-2,1,3,1,3,2
46.0,1,-2,1,3,1,4,3
46.0,1,2,2,6,8,5,1
46.0,1,4,2,6,10,6,2
46.0,1,1,2,7,8,7,3
46.0,1,1,0,2,3,8,1
46.0,1,0,0,2,2,9,2
46.0,1,1,0,2,3,10,3
46.0,1,0,0,2,2,11,4
46.0,1,1,0,2,3,12,5
46.0,2,1,0,2,3,20,6
46.0,2,1,0,2,3,21,7
46.0,2,1,0,2,3,22,8
46.0,2,3,2,7,10,23,1
46.0,2,3,2,7,10,24,2
46.0,2,4,2,7,11,25,3
46.0,2,3,2,7,10,26,4
46.0,2,3,2,7,10,27,5
46.0,2,1,1,3,4,28,1
46.0,3,2,1,2,4,40,2
46.0,3,3,2,6,9,41,1
46.0,3,1,1,3,4,42,1
46.0,3,1,1,3,4,43,2
46.0,3,2,1,2,4,44,3
46.0,3,2,1,2,4,45,4
46.0,3,4,2,7,11,46,1
46.0,3,3,2,7,10,47,2
46.0,3,2,1,2,4,48,1
46.0,3,2,1,2,4,49,2
46.0,4,1,0,2,3,60,1
46.0,4,0,0,2,2,61,2
46.0,4,1,0,2,3,62,3
46.0,4,3,2,5,8,63,1
46.0,4,4,2,7,11,64,2
46.0,4,3,2,6,9,65,3
46.0,4,3,2,6,9,66,4
46.0,4,5,2,6,11,67,5
46.0,4,3,2,6,9,68,6
46.0,5,2,1,2,4,80,1
46.0,5,2,1,2,4,81,2
46.0,5,2,1,2,4,82,3
46.0,5,2,1,2,4,83,4
46.0,5,1,1,3,4,84,5
46.0,5,1,1,3,4,85,6
46.0,5,1,1,3,4,86,7
46.0,5,1,1,3,4,87,8
46.0,5,2,1,2,4,88,9
46.0,5,2,1,2,4,89,10
46.0,5,2,1,2,4,90,11
46.0,5,2,1,2,4,91,12
46.0,5,-1,1,2,1,92,13
47.0,1,-1,0,2,1,0,1
47.0,1,0,0,2,2,1,2
47.0,1,2,1,2,4,2,1
47.0,1,2,1,3,5,3,2
47.0,1,1,1,3,4,4,3
47.0,1,3,2,7,10,5,1
47.0,1,3,2,7,10,6,2
47.0,1,3,2,6,9,7,3
47.0,1,1,0,2,3,8,1
47.0,1,0,0,2,2,9,2
47.0,1,0,0,2,2,10,3
47.0,1,-1,0,2,1,11,4
47.0,2,0,0,2,2,20,5
47.0,2,0,0,2,2,21,6
47.0,2,0,0,2,2,22,7
47.0,2,0,2,7,7,23,1
47.0,2,3,2,8,11,24,2
47.0,2,3,2,6,9,25,3
47.0,2,3,2,6,9,26,4
47.0,2,4,2,5,9,27,5
47.0,2,2,1,2,4,28,1
47.0,2,1,2,6,7,29,1
47.0,3,1,1,2,3,40,1
47.0,3,0,2,6,6,41,1
47.0,3,1,1,2,3,42,1
47.0,3,1,1,2,3,43,2
47.0,3,1,1,2,3,44,3
47.0,3,1,1,2,3,45,4
47.0,3,2,2,5,7,46,1
47.0,3,2,2,7,9,47,2
47.0,3,1,1,3,4,48,1
47.0,3,2,1,2,4,49,2
47.0,3,4,2,7,11,50,1
47.0,4,1,0,2,3,60,1
47.0,4,1,0,2,3,61,2
47.0,4,1,0,2,3,62,3
47.0,4,5,2,6,11,63,1
47.0,4,3,2,6,9,64,2
47.0,4,3,2,7,10,65,3
47.0,4,2,2,6,8,66,4
47.0,4,4,2,6,10,67,5
47.0,4,2,2,7,9,68,6
47.0,5,1,1,2,3,80,1
47.0,5,1,1,2,3,81,2
47.0,5,1,1,2,3,82,3
47.0,5,0,1,3,3,83,4
47.0,5,1,1,2,3,84,5
47.0,5,1,1,2,3,85,6
47.0,5,1,1,2,3,86,7
47.0,5,1,1,2,3,87,8
47.0,5,1,1,2,3,88,9
47.0,5,1,1,2,3,89,10
47.0,5,1,1,2,3,90,11
47.0,5,1,1,2,3,91,12
47.0,5,1,1,2,3,92,13
47.0,5,1,1,2,3,93,14
48.0,1,0,0,2,2,0,1
48.0,1,0,0,2,2,1,2
48.0,1,1,1,2,3,2,1
48.0,1,1,1,2,3,3,2
48.0,1,-2,1,3,1,4,3
48.0,1,-7,2,8,1,5,1
48.0,1,-1,2,6,5,6,2
48.0,1,4,2,7,11,7,3
48.0,1,1,0,2,3,8,1
48.0,1,0,0,2,2,9,2
48.0,1,0,0,2,2,10,3
48.0,1,0,0,2,2,11,4
48.0,1,0,0,2,2,12,5
48.0,1,-3,2,8,5,13,1
48.0,2,0,0,2,2,20,1
48.0,2,0,0,2,2,21,2
48.0,2,0,0,2,2,22,3
48.0,2,0,2,7,7,23,1
48.0,2,0,2,8,8,24,2
48.0,2,3,2,6,9,25,3
48.0,2,5,2,6,11,26,4
48.0,2,2,2,6,8,27,5
48.0,2,2,1,2,4,28,1
48.0,2,2,2,7,9,29,1
48.0,3,0,1,3,3,40,1
48.0,3,1,2,6,7,41,1
48.0,3,1,1,2,3,42,1
48.0,3,1,1,2,3,43,2
48.0,3,1,1,2,3,44,3
48.0,3,1,1,2,3,45,4
48.0,3,2,2,6,8,46,1
48.0,3,2,2,7,9,47,2
48.0,3,2,1,2,4,48,1
48.0,3,2,1,2,4,49,2
48.0,3,2,2,8,10,50,1
48.0,4,0,0,2,2,60,1
48.0,4,0,0,2,2,61,2
48.0,4,0,0,2,2,62,3
48.0,4,0,2,7,7,63,1
48.0,4,0,2,7,7,64,2
48.0,4,0,2,6,6,65,3
48.0,4,1,2,6,7,66,4
48.0,4,2,2,7,9,67,5
48.0,4,3,2,7,10,68,6
48.0,4,0,0,2,2,69,1
48.0,4,1,0,2,3,70,2
48.0,5,2,1,2,4,80,1
48.0,5,2,1,2,4,81,2
48.0,5,2,1,2,4,82,3
48.0,5,2,1,2,4,83,4
48.0,5,2,1,2,4,84,5
48.0,5,2,1,2,4,85,6
48.0,5,2,1,2,4,86,7
48.0,5,2,1,2,4,87,8
48.0,5,2,1,3,5,88,9
48.0,5,2,1,2,4,89,10
48.0,5,2,1,2,4,90,11
48.0,5,2,1,2,4,91,12
50.0,1,-1,0,2,1,0,1
50.0,1,0,0,2,2,1,2
50.0,1,1,1,3,4,2,1
50.0,1,1,1,3,4,3,2
50.0,1,1,1,3,4,4,3
50.0,1,3,2,7,10,5,1
50.0,1,3,2,5,8,6,2
50.0,1,4,2,5,9,7,3
50.0,1,1,0,2,3,8,1
50.0,1,1,0,2,3,9,2
50.0,1,1,0,2,3,10,3
50.0,1,0,0,2,2,11,4
50.0,2,0,0,2,2,20,5
50.0,2,0,0,2,2,21,6
50.0,2,1,0,2,3,22,7
50.0,2,3,2,7,10,23,1
50.0,2,2,2,7,9,24,2
50.0,2,3,2,6,9,25,3
50.0,2,4,2,6,10,26,4
50.0,2,3,2,6,9,27,5
50.0,2,2,1,2,4,28,1
50.0,2,-3,2,7,4,29,1
50.0,3,0,1,3,3,40,1
50.0,3,0,2,5,5,41,1
50.0,3,0,1,3,3,42,1
50.0,3,1,1,2,3,43,2
50.0,3,1,1,2,3,44,3
50.0,3,0,1,3,3,45,4
50.0,3,0,2,6,6,46,1
50.0,3,0,2,8,8,47,2
50.0,3,1,1,2,3,48,1
50.0,3,1,1,3,4,49,2
50.0,3,3,2,6,9,50,1
50.0,3,-2,2,5,3,51,2
50.0,4,0,0,2,2,60,1
50.0,4,0,0,2,2,61,2
50.0,4,0,0,2,2,62,3
50.0,4,0,2,6,6,63,1
50.0,4,0,2,7,7,64,2
50.0,4,0,2,7,7,65,3
50.0,4,3,2,7,10,66,4
50.0,4,0,2,7,7,67,5
50.0,4,0,2,7,7,68,6
50.0,4,0,0,2,2,69,1
50.0,4,0,0,2,2,70,2
50.0,5,1,1,2,3,80,1
50.0,5,1,1,2,3,81,2
50.0,5,0,1,3,3,82,3
50.0,5,1,1,3,4,83,4
50.0,5,2,1,2,4,84,5
50.0,5,2,1,3,5,85,6
50.0,5,2,1,2,4,86,7
50.0,5,2,1,2,4,87,8
50.0,5,1,1,3,4,88,9
50.0,5,2,1,2,4,89,10
50.0,5,2,1,2,4,90,11
50.0,5,2,1,2,4,91,12
50.0,5,1,1,2,3,92,13
53.0,1,-1,0,2,1,0,1
53.0,1,-1,0,2,1,1,2
53.0,1,-2,1,3,1,2,1
53.0,1,2,1,2,4,3,2
53.0,1,2,1,3,5,4,3
53.0,1,3,2,7,10,5,1
53.0,1,3,2,6,9,6,2
53.0,1,3,2,7,10,7,3
53.0,1,1,0,2,3,8,1
53.0,1,1,0,2,3,9,2
53.0,1,1,0,2,3,10,3
53.0,1,1,0,2,3,11,4
53.0,2,0,0,2,2,20,5
53.0,2,1,0,2,3,21,6
53.0,2,0,0,2,2,22,7
53.0,2,3,2,7,10,23,1
53.0,2,3,2,7,10,24,2
53.0,2,3,2,7,10,25,3
53.0,2,0,2,5,5,26,4
53.0,2,2,2,8,10,27,5
53.0,2,1,1,2,3,28,1
53.0,2,0,2,7,7,29,1
53.0,3,2,1,2,4,40,1
53.0,3,2,2,6,8,41,1
53.0,3,2,1,2,4,42,1
53.0,3,2,1,3,5,43,2
53.0,3,2,1,2,4,44,3
53.0,3,2,1,2,4,45,4
53.0,3,3,2,6,9,46,1
53.0,3,3,2,6,9,47,2
53.0,3,2,1,2,4,48,1
53.0,3,2,1,2,4,49,2
53.0,3,-4,2,6,2,50,1
53.0,4,0,0,2,2,60,1
53.0,4,0,0,2,2,61,2
53.0,4,0,0,2,2,62,3
53.0,4,0,2,6,6,63,1
53.0,4,0,2,7,7,64,2
53.0,4,0,2,7,7,65,3
53.0,4,0,2,7,7,66,4
53.0,4,0,2,6,6,67,5
53.0,4,0,2,7,7,68,6
53.0,4,1,0,2,3,69,1
53.0,4,1,0,2,3,70,2
53.0,4,-6,2,7,1,71,1
53.0,5,0,1,3,3,80,1
53.0,5,1,1,2,3,81,2
53.0,5,1,1,2,3,82,3
53.0,5,1,1,2,3,83,4
53.0,5,1,1,2,3,84,5
53.0,5,0,1,3,3,85,6
53.0,5,1,1,2,3,86,7
53.0,5,0,1,3,3,87,8
53.0,5,1,1,2,3,88,9
53.0,5,1,1,2,3,89,10
53.0,5,2,1,2,4,90,11
53.0,5,2,1,2,4,91,12
53.0,5,2,1,2,4,92,13
53.0,5,0,1,2,2,93,14
54.0,1,-1,0,2,1,0,1
54.0,1,0,0,2,2,1,2
54.0,1,1,1,3,4,2,1
54.0,1,-1,1,2,1,3,2
54.0,1,-2,1,3,1,4,3
54.0,1,3,2,6,9,5,1
54.0,1,2,2,7,9,6,2
54.0,1,3,2,6,9,7,3
54.0,1,1,0,2,3,8,1
54.0,1,0,0,2,2,9,2
54.0,1,1,0,2,3,10,3
54.0,1,0,0,2,2,11,4
54.0,1,0,0,2,2,12,5
54.0,2,0,0,2,2,20,6
54.0,2,1,0,2,3,21,7
54.0,2,1,0,2,3,22,8
54.0,2,2,2,7,9,23,1
54.0,2,3,2,6,9,24,2
54.0,2,3,2,7,10,25,3
54.0,2,3,2,6,9,26,4
54.0,2,3,2,7,10,27,5
54.0,2,1,1,3,4,28,1
54.0,2,-4,2,7,3,29,1
54.0,3,0,1,3,3,40,1
54.0,3,0,2,7,7,41,1
54.0,3,1,1,2,3,42,1
54.0,3,0,1,3,3,43,2
54.0,3,0,1,3,3,44,3
54.0,3,1,1,2,3,45,4
54.0,3,2,2,7,9,46,1
54.0,3,2,2,5,7,47,2
54.0,3,2,1,2,4,48,1
54.0,3,2,1,2,4,49,2
54.0,3,4,2,6,10,50,1
54.0,4,1,0,2,3,60,1
54.0,4,1,0,2,3,61,2
54.0,4,1,0,2,3,62,3
54.0,4,3,2,8,11,63,1
54.0,4,3,2,7,10,64,2
54.0,4,4,2,7,11,65,3
54.0,4,4,2,6,10,66,4
54.0,4,3,2,6,9,67,5
54.0,4,0,2,6,6,68,6
54.0,5,1,1,2,3,80,1
54.0,5,1,1,2,3,81,2
54.0,5,1,1,2,3,82,3
54.0,5,1,1,2,3,83,4
54.0,5,1,1,2,3,84,5
54.0,5,1,1,2,3,85,6
54.0,5,1,1,2,3,86,7
54.0,5,1,1,2,3,87,8
54.0,5,1,1,2,3,88,9
54.0,5,1,1,2,3,89,10
54.0,5,2,1,2,4,90,11
54.0,5,2,1,2,4,91,12
54.0,5,1,1,3,4,92,13
54.0,5,0,1,2,2,93,14
55.0,1,1,0,2,3,0,1
55.0,1,0,0,2,2,1,2
55.0,1,1,1,3,4,2,1
55.0,1,1,1,3,4,3,2
55.0,1,1,1,3,4,4,3
55.0,1,3,2,7,10,5,1
55.0,1,2,2,7,9,6,2
55.0,1,1,2,6,7,7,3
55.0,1,1,0,2,3,8,1
55.0,1,0,0,2,2,9,2
55.0,1,0,0,2,2,10,3
55.0,1,0,0,2,2,11,4
55.0,2,1,0,2,3,20,5
55.0,2,1,0,2,3,21,6
55.0,2,0,0,2,2,22,7
55.0,2,2,2,6,8,23,1
55.0,2,3,2,8,11,24,2
55.0,2,4,2,7,11,25,3
55.0,2,3,2,7,10,26,4
55.0,2,4,2,7,11,27,5
55.0,2,2,1,3,5,28,1
55.0,3,2,1,2,4,40,2
55.0,3,4,2,6,10,41,1
55.0,3,2,1,2,4,42,1
55.0,3,2,1,2,4,43,2
55.0,3,2,1,2,4,44,3
55.0,3,2,1,2,4,45,4
55.0,3,4,2,6,10,46,1
55.0,3,2,2,7,9,47,2
55.0,3,1,1,2,3,48,1
55.0,3,2,1,2,4,49,2
55.0,3,-5,2,6,1,50,1
55.0,4,0,0,2,2,60,1
55.0,4,0,0,2,2,61,2
55.0,4,0,0,2,2,62,3
55.0,4,0,2,6,6,63,1
55.0,4,0,2,6,6,64,2
55.0,4,2,2,6,8,65,3
55.0,4,2,2,9,11,66,4
55.0,4,2,2,7,9,67,5
55.0,4,3,2,6,9,68,6
55.0,4,1,0,2,3,69,1
55.0,5,2,1,2,4,80,1
55.0,5,2,1,2,4,81,2
55.0,5,2,1,2,4,82,3
55.0,5,2,1,2,4,83,4
55.0,5,2,1,2,4,84,5
55.0,5,2,1,2,4,85,6
55.0,5,2,1,2,4,86,7
55.0,5,2,1,2,4,87,8
55.0,5,2,1,2,4,88,9
55.0,5,2,1,2,4,89,10
55.0,5,2,1,2,4,90,11
55.0,5,2,1,2,4,91,12
55.0,5,-1,1,2,1,92,13
56.0,1,1,0,2,3,0,1
56.0,1,1,0,2,3,1,2
56.0,1,1,1,3,4,2,1
56.0,1,1,1,3,4,3,2
56.0,1,1,1,3,4,4,3
56.0,1,1,2,7,8,5,1
56.0,1,3,2,6,9,6,2
56.0,1,4,2,7,11,7,3
56.0,1,0,0,2,2,8,1
56.0,1,0,0,2,2,9,2
56.0,1,1,0,2,3,10,3
56.0,2,0,0,2,2,20,4
56.0,2,1,0,2,3,21,5
56.0,2,1,0,2,3,22,6
56.0,2,3,2,6,9,23,1
56.0,2,0,2,6,6,24,2
56.0,2,3,2,8,11,25,3
56.0,2,2,2,7,9,26,4
56.0,2,2,2,7,9,27,5
56.0,2,2,1,2,4,28,1
56.0,2,-1,2,7,6,29,1
56.0,3,0,1,3,3,40,1
56.0,3,0,2,7,7,41,1
56.0,3,1,1,2,3,42,1
56.0,3,1,1,2,3,43,2
56.0,3,0,1,3,3,44,3
56.0,3,0,1,3,3,45,4
56.0,3,2,2,6,8,46,1
56.0,3,3,2,6,9,47,2
56.0,3,2,1,2,4,48,1
56.0,3,1,1,3,4,49,2
56.0,3,3,2,7,10,50,1
56.0,4,1,0,2,3,60,1
56.0,4,0,0,2,2,61,2
56.0,4,1,0,2,3,62,3
56.0,4,2,2,7,9,63,1
56.0,4,4,2,5,9,64,2
56.0,4,4,2,7,11,65,3
56.0,4,3,2,6,9,66,4
56.0,4,5,2,6,11,67,5
56.0,4,3,2,6,9,68,6
56.0,5,1,1,2,3,80,1
56.0,5,1,1,2,3,81,2
56.0,5,1,1,2,3,82,3
56.0,5,1,1,2,3,83,4
56.0,5,0,1,3,3,84,5
56.0,5,1,1,2,3,85,6
56.0,5,1,1,2,3,86,7
56.0,5,1,1,2,3,87,8
56.0,5,1,1,2,3,88,9
56.0,5,1,1,2,3,89,10
56.0,5,1,1,2,3,90,11
56.0,5,1,1,2,3,91,12
56.0,5,1,1,3,4,92,13
56.0,5,2,1,2,4,93,14
57.0,1,-1,0,2,1,0,1
57.0,1,-1,0,2,1,1,2
57.0,1,-2,1,3,1,2,1
57.0,1,-2,1,3,1,3,2
57.0,1,-2,1,3,1,4,3
57.0,1,3,2,7,10,5,1
57.0,1,3,2,7,10,6,2
57.0,1,4,2,6,10,7,3
57.0,1,1,0,2,3,8,1
57.0,1,0,0,2,2,9,2
57.0,1,0,0,2,2,10,3
57.0,1,0,0,2,2,11,4
57.0,1,0,0,2,2,12,5
57.0,2,1,0,2,3,20,6
57.0,2,0,0,2,2,21,7
57.0,2,0,0,2,2,22,8
57.0,2,-1,2,7,6,23,1
57.0,2,2,2,6,8,24,2
57.0,2,2,2,7,9,25,3
57.0,2,3,2,7,10,26,4
57.0,2,3,2,6,9,27,5
57.0,2,2,1,2,4,28,1
57.0,2,2,2,7,9,29,1
57.0,3,1,1,2,3,40,1
57.0,3,0,2,6,6,41,1
57.0,3,1,1,2,3,42,1
57.0,3,1,1,2,3,43,2
57.0,3,1,1,2,3,44,3
57.0,3,1,1,2,3,45,4
57.0,3,2,2,7,9,46,1
57.0,3,2,2,7,9,47,2
57.0,3,1,1,2,3,48,1
57.0,3,1,1,2,3,49,2
57.0,3,3,2,6,9,50,1
57.0,4,0,0,2,2,60,1
57.0,4,0,0,2,2,61,2
57.0,4,0,0,2,2,62,3
57.0,4,4,2,8,12,63,1
57.0,4,3,2,6,9,64,2
57.0,4,3,2,6,9,65,3
57.0,4,3,2,7,10,66,4
57.0,4,4,2,6,10,67,5
57.0,4,3,2,6,9,68,6
57.0,5,2,1,2,4,80,1
57.0,5,1,1,3,4,81,2
57.0,5,2,1,2,4,82,3
57.0,5,2,1,2,4,83,4
57.0,5,2,1,2,4,84,5
57.0,5,2,1,2,4,85,6
57.0,5,1,1,3,4,86,7
57.0,5,1,1,3,4,87,8
57.0,5,2,1,2,4,88,9
57.0,5,2,1,2,4,89,10
57.0,5,2,1,2,4,90,11
57.0,5,2,1,2,4,91,12
57.0,5,-1,1,2,1,92,13
58.0,1,1,0,2,3,0,1
58.0,1,1,0,2,3,1,2
58.0,1,2,1,3,5,2,1
58.0,1,1,1,3,4,3,2
58.0,1,2,1,2,4,4,3
58.0,1,3,2,9,12,5,1
58.0,1,3,2,6,9,6,2
58.0,1,4,2,6,10,7,3
58.0,1,1,0,2,3,8,1
58.0,1,0,0,2,2,9,2
58.0,1,0,0,2,2,10,3
58.0,2,0,0,2,2,20,4
58.0,2,0,0,2,2,21,5
58.0,2,0,0,2,2,22,6
58.0,2,2,2,7,9,23,1
58.0,2,2,2,6,8,24,2
58.0,2,2,2,7,9,25,3
58.0,2,4,2,5,9,26,4
58.0,2,3,2,7,10,27,5
58.0,2,2,1,2,4,28,1
58.0,2,0,2,7,7,29,1
58.0,3,0,1,3,3,40,1
58.0,3,0,2,6,6,41,1
58.0,3,0,1,3,3,42,1
58.0,3,1,1,2,3,43,2
58.0,3,1,1,2,3,44,3
58.0,3,2,1,2,4,45,4
58.0,3,3,2,6,9,46,1
58.0,3,4,2,7,11,47,2
58.0,3,2,1,2,4,48,1
58.0,3,2,1,2,4,49,2
58.0,3,0,2,7,7,50,1
58.0,4,0,0,2,2,60,1
58.0,4,0,0,2,2,61,2
58.0,4,0,0,2,2,62,3
58.0,4,0,2,5,5,63,1
58.0,4,0,2,7,7,64,2
58.0,4,2,2,7,9,65,3
58.0,4,3,2,7,10,66,4
58.0,4,3,2,7,10,67,5
58.0,4,0,2,6,6,68,6
58.0,4,0,0,2,2,69,1
58.0,4,0,0,2,2,70,2
58.0,5,1,1,2,3,80,1
58.0,5,1,1,2,3,81,2
58.0,5,1,1,2,3,82,3
58.0,5,2,1,2,4,83,4
58.0,5,2,1,2,4,84,5
58.0,5,2,1,2,4,85,6
58.0,5,2,1,2,4,86,7
58.0,5,2,1,2,4,87,8
58.0,5,2,1,2,4,88,9
58.0,5,2,1,2,4,89,10
58.0,5,2,1,2,4,90,11
58.0,5,2,1,2,4,91,12
58.0,5,2,1,2,4,92,13
59.0,1,-1,0,2,1,0,1
59.0,1,-1,0,2,1,1,2
59.0,1,1,1,3,4,2,1
59.0,1,2,1,2,4,3,2
59.0,1,1,1,3,4,4,3
59.0,1,3,2,6,9,5,1
59.0,1,3,2,7,10,6,2
59.0,1,3,2,7,10,7,3
59.0,1,1,0,2,3,8,1
59.0,1,1,0,2,3,9,2
59.0,1,0,0,2,2,10,3
59.0,1,0,0,2,2,11,4
59.0,2,1,0,2,3,20,5
59.0,2,1,0,2,3,21,6
59.0,2,0,0,2,2,22,7
59.0,2,2,2,7,9,23,1
59.0,2,3,2,6,9,24,2
59.0,2,3,2,6,9,25,3
59.0,2,4,2,6,10,26,4
59.0,2,4,2,7,11,27,5
59.0,2,2,1,2,4,28,1
59.0,2,-4,2,6,2,29,1
59.0,3,1,1,2,3,40,1
59.0,3,0,2,6,6,41,1
59.0,3,1,1,2,3,42,1
59.0,3,0,1,3,3,43,2
59.0,3,1,1,2,3,44,3
59.0,3,1,1,2,3,45,4
59.0,3,0,2,7,7,46,1
59.0,3,3,2,7,10,47,2
59.0,3,1,1,3,4,48,1
59.0,3,2,1,2,4,49,2
59.0,3,3,2,6,9,50,1
59.0,4,1,0,2,3,60,1
59.0,4,1,0,2,3,61,2
59.0,4,1,0,2,3,62,3
59.0,4,3,2,7,10,63,1
59.0,4,3,2,6,9,64,2
59.0,4,0,2,8,8,65,3
59.0,4,2,2,7,9,66,4
59.0,4,3,2,6,9,67,5
59.0,4,4,2,7,11,68,6
59.0,5,2,1,2,4,80,1
59.0,5,2,1,2,4,81,2
59.0,5,1,1,3,4,82,3
59.0,5,2,1,2,4,83,4
59.0,5,2,1,2,4,84,5
59.0,5,1,1,3,4,85,6
59.0,5,2,1,2,4,86,7
59.0,5,2,1,2,4,87,8
59.0,5,2,1,2,4,88,9
59.0,5,2,1,2,4,89,10
59.0,5,2,1,2,4,90,11
59.0,5,2,1,2,4,91,12
59.0,5,-2,1,3,1,92,13
64.0,1,0,0,2,2,0,1
64.0,1,0,0,2,2,1,2
64.0,1,1,1,3,4,2,1
64.0,1,1,1,3,4,3,2
64.0,1,1,1,3,4,4,3
64.0,1,4,2,6,10,5,1
64.0,1,4,2,7,11,6,2
64.0,1,3,2,6,9,7,3
64.0,1,0,0,2,2,8,1
64.0,1,0,0,2,2,9,2
64.0,1,0,0,2,2,10,3
64.0,1,-1,0,2,1,11,4
64.0,2,0,0,2,2,20,5
64.0,2,0,0,2,2,21,6
64.0,2,0,0,2,2,22,7
64.0,2,2,2,6,8,23,1
64.0,2,2,2,8,10,24,2
64.0,2,2,2,7,9,25,3
64.0,2,0,2,7,7,26,4
64.0,2,0,2,6,6,27,5
64.0,2,1,1,2,3,28,1
64.0,2,3,2,7,10,29,1
64.0,3,0,1,3,3,40,1
64.0,3,4,2,6,10,41,1
64.0,3,2,1,2,4,42,1
64.0,3,2,1,2,4,43,2
64.0,3,2,1,2,4,44,3
64.0,3,1,1,3,4,45,4
64.0,3,3,2,7,10,46,1
64.0,3,4,2,6,10,47,2
64.0,3,1,1,3,4,48,1
64.0,3,2,1,2,4,49,2
64.0,4,1,0,2,3,60,1
64.0,4,0,0,2,2,61,2
64.0,4,1,0,2,3,62,3
64.0,4,4,2,7,11,63,1
64.0,4,4,2,6,10,64,2
64.0,4,3,2,6,9,65,3
64.0,4,3,2,6,9,66,4
64.0,4,3,2,6,9,67,5
64.0,4,2,2,6,8,68,6
64.0,5,1,1,3,4,80,1
64.0,5,2,1,3,5,81,2
64.0,5,2,1,2,4,82,3
64.0,5,2,1,2,4,83,4
64.0,5,2,1,2,4,84,5
64.0,5,2,1,2,4,85,6
64.0,5,2,1,2,4,86,7
64.0,5,2,1,2,4,87,8
64.0,5,2,1,2,4,88,9
64.0,5,2,1,2,4,89,10
64.0,5,2,1,2,4,90,11
64.0,5,2,1,2,4,91,12
65.0,1,0,0,2,2,0,1
65.0,1,0,0,2,2,1,2
65.0,1,1,1,3,4,2,1
65.0,1,2,1,3,5,3,2
65.0,1,-2,1,3,1,4,3
65.0,1,3,2,7,10,5,1
65.0,1,3,2,6,9,6,2
65.0,1,2,2,6,8,7,3
65.0,1,1,0,2,3,8,1
65.0,1,1,0,2,3,9,2
65.0,1,0,0,2,2,10,3
65.0,1,0,0,2,2,11,4
65.0,2,0,0,2,2,20,5
65.0,2,0,0,2,2,21,6
65.0,2,1,0,2,3,22,7
65.0,2,4,2,6,10,23,1
65.0,2,3,2,6,9,24,2
65.0,2,3,2,6,9,25,3
65.0,2,3,2,7,10,26,4
65.0,2,4,2,7,11,27,5
65.0,2,3,1,2,5,28,1
65.0,2,-6,2,7,1,29,1
65.0,3,0,1,3,3,40,1
65.0,3,0,2,8,8,41,1
65.0,3,1,1,2,3,42,1
65.0,3,1,1,2,3,43,2
65.0,3,1,1,2,3,44,3
65.0,3,1,1,2,3,45,4
65.0,3,1,2,8,9,46,1
65.0,3,4,2,7,11,47,2
65.0,3,2,1,2,4,48,1
65.0,3,2,1,2,4,49,2
65.0,3,-1,2,7,6,50,1
65.0,4,0,0,2,2,60,1
65.0,4,1,0,2,3,61,2
65.0,4,0,0,2,2,62,3
65.0,4,0,2,6,6,63,1
65.0,4,0,2,7,7,64,2
65.0,4,0,2,6,6,65,3
65.0,4,3,2,6,9,66,4
65.0,4,1,2,8,9,67,5
65.0,4,1,2,6,7,68,6
65.0,4,0,0,2,2,69,1
65.0,4,0,0,2,2,70,2
65.0,5,2,1,2,4,80,1
65.0,5,2,1,2,4,81,2
65.0,5,2,1,2,4,82,3
65.0,5,1,1,3,4,83,4
65.0,5,2,1,2,4,84,5
65.0,5,2,1,3,5,85,6
65.0,5,2,1,2,4,86,7
65.0,5,2,1,2,4,87,8
65.0,5,1,1,3,4,88,9
65.0,5,2,1,2,4,89,10
65.0,5,2,1,2,4,90,11
65.0,5,2,1,2,4,91,12
69.0,1,1,0,2,3,0,1
69.0,1,1,0,2,3,1,2
69.0,1,0,1,3,3,2,1
69.0,1,1,1,3,4,3,2
69.0,1,0,1,3,3,4,3
69.0,1,4,2,6,10,5,1
69.0,1,3,2,6,9,6,2
69.0,1,3,2,7,10,7,3
69.0,1,1,0,2,3,8,1
69.0,1,0,0,2,2,9,2
69.0,1,0,0,2,2,10,3
69.0,1,-1,0,2,1,11,4
69.0,2,0,0,2,2,20,5
69.0,2,0,0,2,2,21,6
69.0,2,0,0,2,2,22,7
69.0,2,0,2,6,6,23,1
69.0,2,0,2,7,7,24,2
69.0,2,0,2,6,6,25,3
69.0,2,3,2,7,10,26,4
69.0,2,4,2,7,11,27,5
69.0,2,2,1,2,4,28,1
69.0,2,3,2,6,9,29,1
69.0,3,2,1,2,4,40,1
69.0,3,3,2,6,9,41,1
69.0,3,2,1,2,4,42,1
69.0,3,2,1,2,4,43,2
69.0,3,2,1,2,4,44,3
69.0,3,2,1,2,4,45,4
69.0,3,4,2,7,11,46,1
69.0,3,4,2,7,11,47,2
69.0,3,2,1,2,4,48,1
69.0,3,2,1,2,4,49,2
69.0,4,0,0,2,2,60,1
69.0,4,0,0,2,2,61,2
69.0,4,0,0,2,2,62,3
69.0,4,4,2,7,11,63,1
69.0,4,3,2,6,9,64,2
69.0,4,3,2,7,10,65,3
69.0,4,3,2,7,10,66,4
69.0,4,4,2,7,11,67,5
69.0,4,2,2,7,9,68,6
69.0,5,0,1,3,3,80,1
69.0,5,1,1,2,3,81,2
69.0,5,1,1,2,3,82,3
69.0,5,0,1,3,3,83,4
69.0,5,1,1,2,3,84,5
69.0,5,1,1,2,3,85,6
69.0,5,1,1,2,3,86,7
69.0,5,1,1,2,3,87,8
69.0,5,1,1,2,3,88,9
69.0,5,2,1,2,4,89,10
69.0,5,2,1,2,4,90,11
69.0,5,2,1,2,4,91,12
69.0,5,2,1,2,4,92,13
69.0,5,-1,1,2,1,93,14
70.0,1,1,0,2,3,0,1
70.0,1,0,0,2,2,1,2
70.0,1,1,1,3,4,2,1
70.0,1,1,1,3,4,3,2
70.0,1,1,1,3,4,4,3
70.0,1,3,2,7,10,5,1
70.0,1,3,2,7,10,6,2
70.0,1,3,2,7,10,7,3
70.0,1,1,0,2,3,8,1
70.0,1,1,0,2,3,9,2
70.0,1,1,0,2,3,10,3
70.0,2,1,0,2,3,20,4
70.0,2,1,0,2,3,21,5
70.0,2,1,0,2,3,22,6
70.0,2,4,2,6,10,23,1
70.0,2,2,2,6,8,24,2
70.0,2,3,2,7,10,25,3
70.0,2,3,2,7,10,26,4
70.0,2,4,2,8,12,27,5
70.0,2,1,1,3,4,28,1
70.0,3,1,1,3,4,40,2
70.0,3,3,2,5,8,41,1
70.0,3,2,1,2,4,42,1
70.0,3,2,1,2,4,43,2
70.0,3,2,1,2,4,44,3
70.0,3,2,1,2,4,45,4
70.0,3,4,2,6,10,46,1
70.0,3,4,2,6,10,47,2
70.0,3,2,1,2,4,48,1
70.0,3,2,1,2,4,49,2
70.0,3,-7,2,8,1,50,1
70.0,4,0,0,2,2,60,1
70.0,4,0,0,2,2,61,2
70.0,4,1,0,2,3,62,3
70.0,4,0,2,6,6,63,1
70.0,4,0,2,7,7,64,2
70.0,4,0,2,6,6,65,3
70.0,4,0,2,6,6,66,4
70.0,4,3,2,6,9,67,5
70.0,4,3,2,5,8,68,6
70.0,4,1,0,2,3,69,1
70.0,4,0,0,2,2,70,2
70.0,5,2,1,2,4,80,1
70.0,5,2,1,2,4,81,2
70.0,5,2,1,2,4,82,3
70.0,5,2,1,2,4,83,4
70.0,5,2,1,2,4,84,5
70.0,5,2,1,2,4,85,6
70.0,5,1,1,3,4,86,7
70.0,5,2,1,2,4,87,8
70.0,5,2,1,2,4,88,9
70.0,5,2,1,2,4,89,10
70.0,5,1,1,3,4,90,11
70.0,5,1,1,3,4,91,12
70.0,5,-1,1,2,1,92,13
71.0,1,1,0,2,3,0,1
71.0,1,1,0,2,3,1,2
71.0,1,0,1,3,3,2,1
71.0,1,3,1,3,6,3,2
71.0,1,2,1,3,5,4,3
71.0,1,3,2,7,10,5,1
71.0,1,3,2,8,11,6,2
71.0,1,3,2,6,9,7,3
71.0,1,1,0,2,3,8,1
71.0,1,0,0,2,2,9,2
71.0,1,0,0,2,2,10,3
71.0,2,0,0,2,2,20,4
71.0,2,0,0,2,2,21,5
71.0,2,0,0,2,2,22,6
71.0,2,-1,2,7,6,23,1
71.0,2,2,2,6,8,24,2
71.0,2,3,2,7,10,25,3
71.0,2,4,2,7,11,26,4
71.0,2,3,2,7,10,27,5
71.0,2,3,1,2,5,28,1
71.0,2,0,2,6,6,29,1
71.0,3,1,1,2,3,40,1
71.0,3,0,2,7,7,41,1
71.0,3,0,1,3,3,42,1
71.0,3,1,1,2,3,43,2
71.0,3,1,1,2,3,44,3
71.0,3,1,1,2,3,45,4
71.0,3,3,2,6,9,46,1
71.0,3,3,2,6,9,47,2
71.0,3,2,1,2,4,48,1
71.0,3,2,1,2,4,49,2
71.0,3,2,2,7,9,50,1
71.0,4,0,0,2,2,60,1
71.0,4,0,0,2,2,61,2
71.0,4,0,0,2,2,62,3
71.0,4,0,2,7,7,63,1
71.0,4,0,2,6,6,64,2
71.0,4,0,2,6,6,65,3
71.0,4,1,2,6,7,66,4
71.0,4,3,2,6,9,67,5
71.0,4,3,2,6,9,68,6
71.0,4,1,0,2,3,69,1
71.0,4,0,0,2,2,70,2
71.0,5,2,1,2,4,80,1
71.0,5,2,1,2,4,81,2
71.0,5,2,1,2,4,82,3
71.0,5,2,1,2,4,83,4
71.0,5,2,1,2,4,84,5
71.0,5,2,1,3,5,85,6
71.0,5,1,1,3,4,86,7
71.0,5,2,1,2,4,87,8
71.0,5,3,1,2,5,88,9
71.0,5,2,1,3,5,89,10
71.0,5,2,1,2,4,90,11
71.0,5,2,1,2,4,91,12
75.0,1,1,0,2,3,0,1
75.0,1,1,0,2,3,1,2
75.0,1,2,1,3,5,2,1
75.0,1,2,1,3,5,3,2
75.0,1,1,1,3,4,4,3
75.0,1,2,2,7,9,5,1
75.0,1,4,2,7,11,6,2
75.0,1,3,2,8,11,7,3
75.0,1,1,0,2,3,8,1
75.0,1,1,0,2,3,9,2
75.0,2,1,0,2,3,20,3
75.0,2,1,0,2,3,21,4
75.0,2,1,0,2,3,22,5
75.0,2,3,2,7,10,23,1
75.0,2,3,2,7,10,24,2
75.0,2,0,2,8,8,25,3
75.0,2,0,2,7,7,26,4
75.0,2,0,2,7,7,27,5
75.0,2,1,1,2,3,28,1
75.0,2,2,2,6,8,29,1
75.0,3,1,1,2,3,40,1
75.0,3,0,2,5,5,41,1
75.0,3,1,1,2,3,42,1
75.0,3,1,1,2,3,43,2
75.0,3,1,1,2,3,44,3
75.0,3,1,1,2,3,45,4
75.0,3,0,2,8,8,46,1
75.0,3,2,2,7,9,47,2
75.0,3,2,1,2,4,48,1
75.0,3,2,1,2,4,49,2
75.0,3,3,2,6,9,50,1
75.0,4,1,0,2,3,60,1
75.0,4,1,0,2,3,61,2
75.0,4,0,0,2,2,62,3
75.0,4,3,2,7,10,63,1
75.0,4,3,2,7,10,64,2
75.0,4,5,2,5,10,65,3
75.0,4,4,2,4,8,66,4
75.0,4,3,2,7,10,67,5
75.0,4,2,2,6,8,68,6
75.0,5,2,1,2,4,80,1
75.0,5,2,1,2,4,81,2
75.0,5,1,1,3,4,82,3
75.0,5,1,1,3,4,83,4
75.0,5,2,1,2,4,84,5
75.0,5,2,1,2,4,85,6
75.0,5,2,1,2,4,86,7
75.0,5,2,1,2,4,87,8
75.0,5,2,1,2,4,88,9
75.0,5,2,1,2,4,89,10
75.0,5,2,1,2,4,90,11
75.0,5,2,1,2,4,91,12
75.0,5,-1,1,2,1,92,13
76.0,1,1,0,2,3,0,1
76.0,1,1,0,2,3,1,2
76.0,1,1,1,3,4,2,1
76.0,1,1,1,3,4,3,2
76.0,1,1,1,3,4,4,3
76.0,1,3,2,6,9,5,1
76.0,1,2,2,6,8,6,2
76.0,1,3,2,7,10,7,3
76.0,1,0,0,2,2,8,1
76.0,1,1,0,2,3,9,2
76.0,1,1,0,2,3,10,3
76.0,2,1,0,2,3,20,4
76.0,2,0,0,2,2,21,5
76.0,2,1,0,2,3,22,6
76.0,2,3,2,7,10,23,1
76.0,2,4,2,7,11,24,2
76.0,2,3,2,6,9,25,3
76.0,2,3,2,6,9,26,4
76.0,2,4,2,5,9,27,5
76.0,2,2,1,2,4,28,1
76.0,2,-5,2,7,2,29,1
76.0,3,1,1,2,3,40,1
76.0,3,0,2,7,7,41,1
76.0,3,1,1,2,3,42,1
76.0,3,1,1,2,3,43,2
76.0,3,1,1,2,3,44,3
76.0,3,1,1,2,3,45,4
76.0,3,0,2,7,7,46,1
76.0,3,3,2,6,9,47,2
76.0,3,2,1,2,4,48,1
76.0,3,2,1,2,4,49,2
76.0,3,4,2,6,10,50,1
76.0,4,1,0,2,3,60,1
76.0,4,1,0,2,3,61,2
76.0,4,1,0,2,3,62,3
76.0,4,3,2,6,9,63,1
76.0,4,4,2,6,10,64,2
76.0,4,3,2,7,10,65,3
76.0,4,4,2,7,11,66,4
76.0,4,3,2,8,11,67,5
76.0,4,-1,2,7,6,68,6
76.0,5,1,1,2,3,80,1
76.0,5,1,1,2,3,81,2
76.0,5,1,1,2,3,82,3
76.0,5,1,1,2,3,83,4
76.0,5,0,1,3,3,84,5
76.0,5,1,1,2,3,85,6
76.0,5,0,1,2,2,86,7
76.0,5,1,1,2,3,87,8
76.0,5,1,1,3,4,88,9
76.0,5,1,1,2,3,89,10
76.0,5,1,1,2,3,90,11
76.0,5,1,1,2,3,91,12
76.0,5,1,1,2,3,92,13
76.0,5,2,1,2,4,93,14
77.0,1,1,0,2,3,0,1
77.0,1,-1,0,2,1,1,2
77.0,1,1,1,3,4,2,1
77.0,1,1,1,3,4,3,2
77.0,1,2,1,2,4,4,3
77.0,1,2,2,7,9,5,1
77.0,1,3,2,7,10,6,2
77.0,1,3,2,6,9,7,3
77.0,1,1,0,2,3,8,1
77.0,1,1,0,2,3,9,2
77.0,1,0,0,2,2,10,3
77.0,1,-1,0,2,1,11,4
77.0,2,0,0,2,2,20,5
77.0,2,0,0,2,2,21,6
77.0,2,0,0,2,2,22,7
77.0,2,-1,2,7,6,23,1
77.0,2,2,2,7,9,24,2
77.0,2,3,2,7,10,25,3
77.0,2,0,2,6,6,26,4
77.0,2,0,2,7,7,27,5
77.0,2,2,1,2,4,28,1
77.0,2,3,2,7,10,29,1
77.0,3,1,1,3,4,40,1
77.0,3,3,2,7,10,41,1
77.0,3,2,1,2,4,42,1
77.0,3,2,1,2,4,43,2
77.0,3,2,1,2,4,44,3
77.0,3,2,1,2,4,45,4
77.0,3,3,2,6,9,46,1
77.0,3,3,2,6,9,47,2
77.0,3,1,1,3,4,48,1
77.0,3,1,1,3,4,49,2
77.0,3,-5,2,6,1,50,1
77.0,4,0,0,2,2,60,1
77.0,4,0,0,2,2,61,2
77.0,4,0,0,2,2,62,3
77.0,4,0,2,7,7,63,1
77.0,4,0,2,7,7,64,2
77.0,4,0,2,5,5,65,3
77.0,4,0,2,7,7,66,4
77.0,4,3,2,7,10,67,5
77.0,4,4,2,6,10,68,6
77.0,4,0,0,2,2,69,1
77.0,4,1,0,2,3,70,2
77.0,5,1,1,3,4,80,1
77.0,5,2,1,2,4,81,2
77.0,5,1,1,2,3,82,3
77.0,5,1,1,3,4,83,4
77.0,5,2,1,2,4,84,5
77.0,5,2,1,2,4,85,6
77.0,5,2,1,2,4,86,7
77.0,5,1,1,3,4,87,8
77.0,5,2,1,2,4,88,9
77.0,5,3,1,2,5,89,10
77.0,5,2,1,2,4,90,11
77.0,5,1,1,3,4,91,12
77.0,5,-1,1,2,1,92,13
78.0,1,1,0,2,3,0,1
78.0,1,-1,0,2,1,1,2
78.0,1,-2,1,3,1,2,1
78.0,1,-2,1,3,1,3,2
78.0,1,-2,1,3,1,4,3
78.0,1,-5,2,6,1,5,1
78.0,1,-9,2,10,1,6,2
78.0,1,-8,2,9,1,7,3
78.0,1,-1,0,2,1,8,1
78.0,1,-1,0,2,1,9,2
78.0,1,0,0,2,2,10,3
78.0,1,0,0,2,2,11,4
78.0,1,0,0,2,2,12,5
78.0,1,-8,2,9,1,13,1
78.0,1,0,2,5,5,14,2
78.0,1,0,1,3,3,15,1
78.0,1,-4,2,8,4,16,1
78.0,2,0,0,2,2,20,1
78.0,2,0,0,2,2,21,2
78.0,2,0,0,2,2,22,3
78.0,2,-1,2,7,6,23,1
78.0,2,-1,2,7,6,24,2
78.0,2,2,2,9,11,25,3
78.0,2,3,2,6,9,26,4
78.0,2,3,2,7,10,27,5
78.0,2,2,1,2,4,28,1
78.0,2,3,2,7,10,29,1
78.0,3,2,1,2,4,40,1
78.0,3,4,2,7,11,41,1
78.0,3,2,1,2,4,42,1
78.0,3,2,1,3,5,43,2
78.0,3,2,1,2,4,44,3
78.0,3,2,1,2,4,45,4
78.0,3,4,2,8,12,46,1
78.0,3,3,2,7,10,47,2
78.0,3,2,1,2,4,48,1
78.0,3,2,1,2,4,49,2
78.0,4,1,0,2,3,60,1
78.0,4,1,0,2,3,61,2
78.0,4,1,0,2,3,62,3
78.0,4,3,2,7,10,63,1
78.0,4,3,2,7,10,64,2
78.0,4,3,2,8,11,65,3
78.0,4,3,2,6,9,66,4
78.0,4,4,2,6,10,67,5
78.0,4,0,2,7,7,68,6
78.0,5,0,1,3,3,80,1
78.0,5,0,1,3,3,81,2
78.0,5,0,1,3,3,82,3
78.0,5,1,1,2,3,83,4
78.0,5,1,1,2,3,84,5
78.0,5,1,1,2,3,85,6
78.0,5,1,1,2,3,86,7
78.0,5,1,1,3,4,87,8
78.0,5,2,1,2,4,88,9
78.0,5,2,1,2,4,89,10
78.0,5,2,1,2,4,90,11
78.0,5,2,1,2,4,91,12
78.0,5,1,1,3,4,92,13
80.0,1,1,0,2,3,0,1
80.0,1,1,0,2,3,1,2
80.0,1,1,1,3,4,2,1
80.0,1,1,1,3,4,3,2
80.0,1,-2,1,3,1,4,3
80.0,1,2,2,6,8,5,1
80.0,1,1,2,8,9,6,2
80.0,1,3,2,6,9,7,3
80.0,1,1,0,2,3,8,1
80.0,1,1,0,2,3,9,2
80.0,1,0,0,2,2,10,3
80.0,1,1,0,2,3,11,4
80.0,2,0,0,2,2,20,5
80.0,2,1,0,2,3,21,6
80.0,2,1,0,2,3,22,7
80.0,2,2,2,7,9,23,1
80.0,2,2,2,7,9,24,2
80.0,2,3,2,7,10,25,3
80.0,2,2,2,6,8,26,4
80.0,2,4,2,6,10,27,5
80.0,2,2,1,2,4,28,1
80.0,2,-3,2,7,4,29,1
80.0,3,0,1,3,3,40,1
80.0,3,0,2,6,6,41,1
80.0,3,1,1,2,3,42,1
80.0,3,1,1,2,3,43,2
80.0,3,0,1,3,3,44,3
80.0,3,1,1,2,3,45,4
80.0,3,0,2,7,7,46,1
80.0,3,2,2,7,9,47,2
80.0,3,2,1,2,4,48,1
80.0,3,2,1,2,4,49,2
80.0,3,4,2,7,11,50,1
80.0,4,1,0,2,3,60,1
80.0,4,0,0,2,2,61,2
80.0,4,0,0,2,2,62,3
80.0,4,0,2,7,7,63,1
80.0,4,4,2,6,10,64,2
80.0,4,4,2,6,10,65,3
80.0,4,2,2,6,8,66,4
80.0,4,3,2,5,8,67,5
80.0,4,3,2,6,9,68,6
80.0,4,1,0,2,3,69,1
80.0,5,1,1,3,4,80,1
80.0,5,2,1,2,4,81,2
80.0,5,2,1,2,4,82,3
80.0,5,2,1,2,4,83,4
80.0,5,1,1,2,3,84,5
80.0,5,2,1,2,4,85,6
80.0,5,1,1,3,4,86,7
80.0,5,2,1,2,4,87,8
80.0,5,2,1,2,4,88,9
80.0,5,2,1,2,4,89,10
80.0,5,2,1,2,4,90,11
80.0,5,2,1,2,4,91,12
80.0,5,0,1,2,2,92,13
81.0,1,-1,0,2,1,0,1
81.0,1,1,0,2,3,1,2
81.0,1,0,1,3,3,2,1
81.0,1,1,1,3,4,3,2
81.0,1,2,1,2,4,4,3
81.0,1,3,2,6,9,5,1
81.0,1,4,2,7,11,6,2
81.0,1,4,2,7,11,7,3
81.0,1,0,0,2,2,8,1
81.0,1,1,0,2,3,9,2
81.0,1,1,0,2,3,10,3
81.0,2,0,0,2,2,20,4
81.0,2,0,0,2,2,21,5
81.0,2,0,0,2,2,22,6
81.0,2,0,2,7,7,23,1
81.0,2,0,2,6,6,24,2
81.0,2,0,2,7,7,25,3
81.0,2,0,2,7,7,26,4
81.0,2,1,2,8,9,27,5
81.0,2,3,1,2,5,28,1
81.0,2,2,2,6,8,29,1
81.0,2,-6,2,8,2,30,2
81.0,3,1,1,2,3,40,1
81.0,3,0,2,6,6,41,1
81.0,3,1,1,2,3,42,1
81.0,3,1,1,2,3,43,2
81.0,3,1,1,2,3,44,3
81.0,3,1,1,2,3,45,4
81.0,3,3,2,7,10,46,1
81.0,3,4,2,7,11,47,2
81.0,3,2,1,2,4,48,1
81.0,3,2,1,2,4,49,2
81.0,3,1,2,6,7,50,1
81.0,4,0,0,2,2,60,1
81.0,4,0,0,2,2,61,2
81.0,4,0,0,2,2,62,3
81.0,4,0,2,6,6,63,1
81.0,4,0,2,6,6,64,2
81.0,4,1,2,5,6,65,3
81.0,4,4,2,5,9,66,4
81.0,4,4,2,6,10,67,5
81.0,4,3,2,6,9,68,6
81.0,4,1,0,2,3,69,1
81.0,4,0,0,2,2,70,2
81.0,5,2,1,2,4,80,1
81.0,5,2,1,2,4,81,2
81.0,5,2,1,2,4,82,3
81.0,5,2,1,2,4,83,4
81.0,5,2,1,2,4,84,5
81.0,5,2,1,2,4,85,6
81.0,5,2,1,2,4,86,7
81.0,5,2,1,2,4,87,8
81.0,5,2,1,2,4,88,9
81.0,5,2,1,2,4,89,10
81.0,5,2,1,2,4,90,11
81.0,5,3,1,2,5,91,12
82.0,1,-1,0,2,1,0,1
82.0,1,0,0,2,2,1,2
82.0,1,-2,1,3,1,2,1
82.0,1,2,1,2,4,3,2
82.0,1,1,1,3,4,4,3
82.0,1,3,2,6,9,5,1
82.0,1,3,2,7,10,6,2
82.0,1,3,2,6,9,7,3
82.0,1,1,0,2,3,8,1
82.0,1,0,0,2,2,9,2
82.0,1,1,0,2,3,10,3
82.0,1,0,0,2,2,11,4
82.0,2,1,0,2,3,20,5
82.0,2,1,0,2,3,21,6
82.0,2,1,0,2,3,22,7
82.0,2,2,2,8,10,23,1
82.0,2,3,2,7,10,24,2
82.0,2,4,2,6,10,25,3
82.0,2,3,2,6,9,26,4
82.0,2,4,2,7,11,27,5
82.0,2,2,1,2,4,28,1
82.0,3,2,1,2,4,40,2
82.0,3,3,2,7,10,41,1
82.0,3,2,1,2,4,42,1
82.0,3,2,1,2,4,43,2
82.0,3,2,1,2,4,44,3
82.0,3,2,1,2,4,45,4
82.0,3,4,2,6,10,46,1
82.0,3,3,2,6,9,47,2
82.0,3,2,1,2,4,48,1
82.0,3,2,1,2,4,49,2
82.0,4,1,0,2,3,60,1
82.0,4,0,0,2,2,61,2
82.0,4,1,0,2,3,62,3
82.0,4,3,2,7,10,63,1
82.0,4,3,2,6,9,64,2
82.0,4,3,2,8,11,65,3
82.0,4,3,2,8,11,66,4
82.0,4,3,2,7,10,67,5
82.0,4,0,2,7,7,68,6
82.0,5,1,1,2,3,80,1
82.0,5,0,1,3,3,81,2
82.0,5,1,1,2,3,82,3
82.0,5,1,1,2,3,83,4
82.0,5,1,1,2,3,84,5
82.0,5,1,1,2,3,85,6
82.0,5,1,1,2,3,86,7
82.0,5,1,1,2,3,87,8
82.0,5,2,1,2,4,88,9
82.0,5,2,1,2,4,89,10
82.0,5,1,1,3,4,90,11
82.0,5,2,1,2,4,91,12
82.0,5,1,1,3,4,92,13
85.0,1,0,0,2,2,0,1
85.0,1,1,0,2,3,1,2
85.0,1,0,1,3,3,2,1
85.0,1,-2,1,3,1,3,2
85.0,1,1,1,3,4,4,3
85.0,1,-8,2,9,1,5,1
85.0,1,4,2,6,10,6,2
85.0,1,2,2,7,9,7,3
85.0,1,1,0,2,3,8,1
85.0,1,1,0,2,3,9,2
85.0,1,1,0,2,3,10,3
85.0,1,1,0,2,3,11,4
85.0,1,1,0,2,3,12,5
85.0,2,1,0,2,3,20,6
85.0,2,1,0,2,3,21,7
85.0,2,1,0,2,3,22,8
85.0,2,3,2,8,11,23,1
85.0,2,2,2,8,10,24,2
85.0,2,1,2,6,7,25,3
85.0,2,0,2,7,7,26,4
85.0,2,3,2,7,10,27,5
85.0,2,2,1,2,4,28,1
85.0,2,-3,2,7,4,29,1
85.0,3,1,1,2,3,40,1
85.0,3,0,2,7,7,41,1
85.0,3,0,1,3,3,42,1
85.0,3,1,1,2,3,43,2
85.0,3,0,1,3,3,44,3
85.0,3,1,1,2,3,45,4
85.0,3,1,2,7,8,46,1
85.0,3,0,2,6,6,47,2
85.0,3,0,1,3,3,48,1
85.0,3,0,1,3,3,49,2
85.0,3,0,2,6,6,50,1
85.0,3,-1,2,6,5,51,2
85.0,4,0,0,2,2,60,1
85.0,4,0,0,2,2,61,2
85.0,4,0,0,2,2,62,3
85.0,4,0,2,7,7,63,1
85.0,4,0,2,6,6,64,2
85.0,4,0,2,6,6,65,3
85.0,4,2,2,7,9,66,4
85.0,4,3,2,7,10,67,5
85.0,4,4,2,6,10,68,6
85.0,4,1,0,2,3,69,1
85.0,5,2,1,2,4,80,1
85.0,5,2,1,2,4,81,2
85.0,5,2,1,2,4,82,3
85.0,5,2,1,2,4,83,4
85.0,5,1,1,3,4,84,5
85.0,5,2,1,2,4,85,6
85.0,5,2,1,2,4,86,7
85.0,5,2,1,2,4,87,8
85.0,5,2,1,2,4,88,9
85.0,5,2,1,2,4,89,10
85.0,5,2,1,2,4,90,11
85.0,5,2,1,2,4,91,12
85.0,5,-2,1,3,1,92,13
89.0,1,-1,0,2,1,0,1
89.0,1,1,0,2,3,1,2
89.0,1,2,1,3,5,2,1
89.0,1,1,1,3,4,3,2
89.0,1,1,1,3,4,4,3
89.0,1,3,2,6,9,5,1
89.0,1,3,2,7,10,6,2
89.0,1,3,2,7,10,7,3
89.0,1,1,0,2,3,8,1
89.0,1,1,0,2,3,9,2
89.0,1,1,0,2,3,10,3
89.0,2,0,0,2,2,20,4
89.0,2,1,0,2,3,21,5
89.0,2,1,0,2,3,22,6
89.0,2,2,2,7,9,23,1
89.0,2,3,2,6,9,24,2
89.0,2,4,2,7,11,25,3
89.0,2,3,2,5,8,26,4
89.0,2,3,2,6,9,27,5
89.0,2,2,1,2,4,28,1
89.0,2,-2,2,6,4,29,1
89.0,3,0,1,3,3,40,1
89.0,3,0,2,7,7,41,1
89.0,3,1,1,2,3,42,1
89.0,3,1,1,2,3,43,2
89.0,3,1,1,2,3,44,3
89.0,3,1,1,2,3,45,4
89.0,3,1,2,7,8,46,1
89.0,3,4,2,5,9,47,2
89.0,3,1,1,3,4,48,1
89.0,3,1,1,2,3,49,2
89.0,3,0,2,7,7,50,1
89.0,4,0,0,2,2,60,1
89.0,4,1,0,2,3,61,2
89.0,4,0,0,2,2,62,3
89.0,4,3,2,8,11,63,1
89.0,4,0,2,7,7,64,2
89.0,4,1,2,8,9,65,3
89.0,4,0,2,6,6,66,4
89.0,4,0,2,6,6,67,5
89.0,4,3,2,7,10,68,6
89.0,4,0,0,2,2,69,1
89.0,5,2,1,2,4,80,1
89.0,5,2,1,2,4,81,2
89.0,5,2,1,2,4,82,3
89.0,5,2,1,2,4,83,4
89.0,5,2,1,2,4,84,5
89.0,5,2,1,2,4,85,6
89.0,5,2,1,2,4,86,7
89.0,5,2,1,2,4,87,8
89.0,5,2,1,2,4,88,9
89.0,5,1,1,3,4,89,10
89.0,5,2,1,2,4,90,11
89.0,5,2,1,2,4,91,12
89.0,5,-1,1,2,1,92,13
92.0,1,1,0,2,3,0,1
92.0,1,1,0,2,3,1,2
92.0,1,1,1,3,4,2,1
92.0,1,0,1,3,3,3,2
92.0,1,1,1,3,4,4,3
92.0,1,2,2,6,8,5,1
92.0,1,2,2,7,9,6,2
92.0,1,0,2,6,6,7,3
92.0,1,1,0,2,3,8,1
92.0,1,0,0,2,2,9,2
92.0,1,1,0,2,3,10,3
92.0,1,0,0,2,2,11,4
92.0,2,0,0,2,2,20,5
92.0,2,1,0,2,3,21,6
92.0,2,1,0,2,3,22,7
92.0,2,3,2,6,9,23,1
92.0,2,3,2,7,10,24,2
92.0,2,3,2,7,10,25,3
92.0,2,3,2,6,9,26,4
92.0,2,5,2,8,13,27,5
92.0,2,1,1,3,4,28,1
92.0,3,1,1,3,4,40,2
92.0,3,3,2,8,11,41,1
92.0,3,2,1,2,4,42,1
92.0,3,2,1,2,4,43,2
92.0,3,2,1,2,4,44,3
92.0,3,2,1,2,4,45,4
92.0,3,3,2,6,9,46,1
92.0,3,3,2,5,8,47,2
92.0,3,2,1,2,4,48,1
92.0,3,2,1,2,4,49,2
92.0,3,-6,2,7,1,50,1
92.0,4,0,0,2,2,60,1
92.0,4,0,0,2,2,61,2
92.0,4,1,0,2,3,62,3
92.0,4,0,2,6,6,63,1
92.0,4,0,2,6,6,64,2
92.0,4,0,2,8,8,65,3
92.0,4,0,2,7,7,66,4
92.0,4,5,2,6,11,67,5
92.0,4,2,2,7,9,68,6
92.0,4,1,0,2,3,69,1
92.0,5,2,1,2,4,80,1
92.0,5,1,1,3,4,81,2
92.0,5,2,1,2,4,82,3
92.0,5,2,1,2,4,83,4
92.0,5,2,1,2,4,84,5
92.0,5,2,1,2,4,85,6
92.0,5,2,1,2,4,86,7
92.0,5,2,1,2,4,87,8
92.0,5,1,1,3,4,88,9
92.0,5,2,1,2,4,89,10
92.0,5,2,1,2,4,90,11
92.0,5,1,1,3,4,91,12
92.0,5,-1,1,2,1,92,13
94.0,1,-1,0,2,1,0,1
94.0,1,-1,0,2,1,1,2
94.0,1,2,1,2,4,2,1
94.0,1,2,1,2,4,3,2
94.0,1,1,1,3,4,4,3
94.0,1,3,2,7,10,5,1
94.0,1,4,2,7,11,6,2
94.0,1,3,2,6,9,7,3
94.0,1,0,0,2,2,8,1
94.0,1,1,0,2,3,9,2
94.0,1,1,0,2,3,10,3
94.0,1,-1,0,2,1,11,4
94.0,2,0,0,2,2,20,5
94.0,2,0,0,2,2,21,6
94.0,2,0,0,2,2,22,7
94.0,2,0,2,7,7,23,1
94.0,2,0,2,6,6,24,2
94.0,2,3,2,7,10,25,3
94.0,2,3,2,6,9,26,4
94.0,2,3,2,7,10,27,5
94.0,2,2,1,2,4,28,1
94.0,2,3,2,7,10,29,1
94.0,3,2,1,2,4,40,1
94.0,3,3,2,7,10,41,1
94.0,3,2,1,2,4,42,1
94.0,3,1,1,3,4,43,2
94.0,3,1,1,3,4,44,3
94.0,3,2,1,2,4,45,4
94.0,3,4,2,7,11,46,1
94.0,3,3,2,7,10,47,2
94.0,3,2,1,2,4,48,1
94.0,3,2,1,2,4,49,2
94.0,4,1,0,2,3,60,1
94.0,4,0,0,2,2,61,2
94.0,4,0,0,2,2,62,3
94.0,4,5,2,6,11,63,1
94.0,4,4,2,6,10,64,2
94.0,4,3,2,7,10,65,3
94.0,4,3,2,7,10,66,4
94.0,4,4,2,6,10,67,5
94.0,4,3,2,5,8,68,6
94.0,5,2,1,2,4,80,1
94.0,5,2,1,2,4,81,2
94.0,5,2,1,2,4,82,3
94.0,5,2,1,2,4,83,4
94.0,5,2,1,2,4,84,5
94.0,5,1,1,3,4,85,6
94.0,5,2,1,2,4,86,7
94.0,5,2,1,2,4,87,8
94.0,5,2,1,2,4,88,9
94.0,5,2,1,3,5,89,10
94.0,5,2,1,2,4,90,11
94.0,5,2,1,2,4,91,12
96.0,1,1,0,2,3,0,1
96.0,1,1,0,2,3,1,2
96.0,1,1,1,3,4,2,1
96.0,1,1,1,3,4,3,2
96.0,1,1,1,3,4,4,3
96.0,1,4,2,8,12,5,1
96.0,1,2,2,6,8,6,2
96.0,1,3,2,5,8,7,3
96.0,1,1,0,2,3,8,1
96.0,1,1,0,2,3,9,2
96.0,1,0,0,2,2,10,3
96.0,2,0,0,2,2,20,4
96.0,2,2,0,2,4,21,5
96.0,2,1,0,2,3,22,6
96.0,2,3,2,7,10,23,1
96.0,2,2,2,6,8,24,2
96.0,2,2,2,8,10,25,3
96.0,2,3,2,6,9,26,4
96.0,2,3,2,7,10,27,5
96.0,2,1,1,3,4,28,1
96.0,2,-4,2,6,2,29,1
96.0,3,1,1,2,3,40,1
96.0,3,0,2,5,5,41,1
96.0,3,1,1,2,3,42,1
96.0,3,1,1,2,3,43,2
96.0,3,0,1,3,3,44,3
96.0,3,0,1,3,3,45,4
96.0,3,4,2,5,9,46,1
96.0,3,3,2,7,10,47,2
96.0,3,2,1,2,4,48,1
96.0,3,1,1,3,4,49,2
96.0,3,3,2,7,10,50,1
96.0,4,0,0,2,2,60,1
96.0,4,0,0,2,2,61,2
96.0,4,0,0,2,2,62,3
96.0,4,0,2,6,6,63,1
96.0,4,0,2,6,6,64,2
96.0,4,0,2,8,8,65,3
96.0,4,0,2,6,6,66,4
96.0,4,2,2,6,8,67,5
96.0,4,3,2,7,10,68,6
96.0,4,1,0,2,3,69,1
96.0,4,0,0,2,2,70,2
96.0,5,2,1,2,4,80,1
96.0,5,2,1,3,5,81,2
96.0,5,2,1,2,4,82,3
96.0,5,2,1,2,4,83,4
96.0,5,1,1,3,4,84,5
96.0,5,1,1,3,4,85,6
96.0,5,1,1,3,4,86,7
96.0,5,2,1,2,4,87,8
96.0,5,2,1,2,4,88,9
96.0,5,2,1,2,4,89,10
96.0,5,2,1,2,4,90,11
96.0,5,2,1,2,4,91,12
97.0,1,1,0,2,3,0,1
97.0,1,0,0,2,2,1,2
97.0,1,-2,1,3,1,2,1
97.0,1,-2,1,3,1,3,2
97.0,1,-2,1,3,1,4,3
97.0,1,-8,2,9,1,5,1
97.0,1,1,2,6,7,6,2
97.0,1,5,2,6,11,7,3
97.0,1,0,0,2,2,8,1
97.0,1,1,0,2,3,9,2
97.0,1,1,0,2,3,10,3
97.0,1,0,0,2,2,11,4
97.0,1,1,0,2,3,12,5
97.0,1,-2,2,6,4,13,1
97.0,2,0,0,2,2,20,1
97.0,2,0,0,2,2,21,2
97.0,2,0,0,2,2,22,3
97.0,2,2,2,7,9,23,1
97.0,2,3,2,7,10,24,2
97.0,2,3,2,7,10,25,3
97.0,2,3,2,7,10,26,4
97.0,2,4,2,8,12,27,5
97.0,2,1,1,3,4,28,1
97.0,2,-6,2,7,1,29,1
97.0,3,1,1,2,3,40,1
97.0,3,0,2,7,7,41,1
97.0,3,1,1,2,3,42,1
97.0,3,0,1,3,3,43,2
97.0,3,1,1,2,3,44,3
97.0,3,1,1,2,3,45,4
97.0,3,2,2,8,10,46,1
97.0,3,3,2,5,8,47,2
97.0,3,2,1,2,4,48,1
97.0,3,1,1,3,4,49,2
97.0,3,2,2,6,8,50,1
97.0,4,0,0,2,2,60,1
97.0,4,1,0,2,3,61,2
97.0,4,1,0,2,3,62,3
97.0,4,4,2,6,10,63,1
97.0,4,2,2,7,9,64,2
97.0,4,3,2,8,11,65,3
97.0,4,4,2,7,11,66,4
97.0,4,2,2,7,9,67,5
97.0,4,1,2,7,8,68,6
97.0,5,1,1,2,3,80,1
97.0,5,1,1,2,3,81,2
97.0,5,1,1,2,3,82,3
97.0,5,0,1,3,3,83,4
97.0,5,1,1,2,3,84,5
97.0,5,1,1,2,3,85,6
97.0,5,1,1,2,3,86,7
97.0,5,0,1,3,3,87,8
97.0,5,1,1,2,3,88,9
97.0,5,1,1,2,3,89,10
97.0,5,1,1,2,3,90,11
97.0,5,2,1,2,4,91,12
97.0,5,2,1,2,4,92,13
97.0,5,0,1,3,3,93,14
99.0,1,0,0,2,2,0,1
99.0,1,1,0,2,3,1,2
99.0,1,0,1,3,3,2,1
99.0,1,0,1,3,3,3,2
99.0,1,1,1,3,4,4,3
99.0,1,4,2,6,10,5,1
99.0,1,2,2,7,9,6,2
99.0,1,3,2,6,9,7,3
99.0,1,1,0,2,3,8,1
99.0,1,1,0,2,3,9,2
99.0,1,0,0,2,2,10,3
99.0,1,0,0,2,2,11,4
99.0,2,0,0,2,2,20,5
99.0,2,0,0,2,2,21,6
99.0,2,0,0,2,2,22,7
99.0,2,0,2,7,7,23,1
99.0,2,3,2,8,11,24,2
99.0,2,3,2,7,10,25,3
99.0,2,4,2,6,10,26,4
99.0,2,3,2,6,9,27,5
99.0,2,1,1,2,3,28,1
99.0,2,0,2,6,6,29,1
99.0,3,2,1,2,4,40,1
99.0,3,3,2,7,10,41,1
99.0,3,2,1,2,4,42,1
99.0,3,2,1,2,4,43,2
99.0,3,2,1,2,4,44,3
99.0,3,2,1,2,4,45,4
99.0,3,4,2,7,11,46,1
99.0,3,3,2,7,10,47,2
99.0,3,2,1,2,4,48,1
99.0,3,2,1,2,4,49,2
99.0,4,0,0,2,2,60,1
99.0,4,0,0,2,2,61,2
99.0,4,1,0,2,3,62,3
99.0,4,5,2,7,12,63,1
99.0,4,3,2,7,10,64,2
99.0,4,4,2,6,10,65,3
99.0,4,3,2,6,9,66,4
99.0,4,3,2,6,9,67,5
99.0,4,3,2,6,9,68,6
99.0,5,2,1,2,4,80,1
99.0,5,1,1,3,4,81,2
99.0,5,2,1,2,4,82,3
99.0,5,2,1,2,4,83,4
99.0,5,2,1,2,4,84,5
99.0,5,2,1,2,4,85,6
99.0,5,2,1,2,4,86,7
99.0,5,2,1,2,4,87,8
99.0,5,2,1,2,4,88,9
99.0,5,2,1,2,4,89,10
99.0,5,2,1,2,4,90,11
99.0,5,1,1,3,4,91,12
99.0,5,-2,1,3,1,92,13
100.0,1,1,0,2,3,0,1
100.0,1,1,0,2,3,1,2
100.0,1,2,1,2,4,2,1
100.0,1,1,1,2,3,3,2
100.0,1,1,1,3,4,4,3
100.0,1,4,2,6,10,5,1
100.0,1,2,2,7,9,6,2
100.0,1,3,2,8,11,7,3
100.0,1,1,0,2,3,8,1
100.0,1,1,0,2,3,9,2
100.0,1,0,0,2,2,10,3
100.0,2,0,0,2,2,20,4
100.0,2,0,0,2,2,21,5
100.0,2,0,0,2,2,22,6
100.0,2,0,2,7,7,23,1
100.0,2,0,2,7,7,24,2
100.0,2,3,2,7,10,25,3
100.0,2,4,2,5,9,26,4
100.0,2,4,2,6,10,27,5
100.0,2,2,1,2,4,28,1
100.0,2,3,2,6,9,29,1
100.0,3,2,1,2,4,40,1
100.0,3,3,2,7,10,41,1
100.0,3,2,1,2,4,42,1
100.0,3,2,1,2,4,43,2
100.0,3,2,1,3,5,44,3
100.0,3,1,1,3,4,45,4
100.0,3,4,2,7,11,46,1
100.0,3,3,2,7,10,47,2
100.0,3,2,1,2,4,48,1
100.0,3,1,1,3,4,49,2
100.0,4,1,0,2,3,60,1
100.0,4,1,0,2,3,61,2
100.0,4,1,0,2,3,62,3
100.0,4,3,2,8,11,63,1
100.0,4,2,2,6,8,64,2
100.0,4,3,2,7,10,65,3
100.0,4,3,2,7,10,66,4
100.0,4,1,2,7,8,67,5
100.0,4,0,2,6,6,68,6
100.0,5,1,1,2,3,80,1
100.0,5,2,1,2,4,81,2
100.0,5,2,1,2,4,82,3
100.0,5,1,1,3,4,83,4
100.0,5,1,1,2,3,84,5
100.0,5,1,1,2,3,85,6
100.0,5,2,1,2,4,86,7
100.0,5,2,1,2,4,87,8
100.0,5,1,1,3,4,88,9
100.0,5,1,1,3,4,89,10
100.0,5,2,1,2,4,90,11
100.0,5,1,1,3,4,91,12
100.0,5,2,1,2,4,92,13
101.0,1,0,0,2,2,0,1
101.0,1,1,0,2,3,1,2
101.0,1,0,1,3,3,2,1
101.0,1,0,1,3,3,3,2
101.0,1,1,1,3,4,4,3
101.0,1,3,2,6,9,5,1
101.0,1,3,2,7,10,6,2
101.0,1,4,2,6,10,7,3
101.0,1,0,0,2,2,8,1
101.0,1,2,0,2,4,9,2
101.0,1,1,0,2,3,10,3
101.0,2,1,0,2,3,20,4
101.0,2,0,0,2,2,21,5
101.0,2,1,0,2,3,22,6
101.0,2,3,2,7,10,23,1
101.0,2,3,2,7,10,24,2
101.0,2,3,2,7,10,25,3
101.0,2,3,2,7,10,26,4
101.0,2,3,2,8,11,27,5
101.0,2,1,1,3,4,28,1
101.0,3,2,1,2,4,40,2
101.0,3,3,2,7,10,41,1
101.0,3,1,1,3,4,42,1
101.0,3,2,1,2,4,43,2
101.0,3,2,1,2,4,44,3
101.0,3,1,1,3,4,45,4
101.0,3,4,2,7,11,46,1
101.0,3,3,2,6,9,47,2
101.0,3,2,1,2,4,48,1
101.0,3,2,1,2,4,49,2
101.0,4,1,0,2,3,60,1
101.0,4,1,0,2,3,61,2
101.0,4,1,0,2,3,62,3
101.0,4,3,2,6,9,63,1
101.0,4,4,2,7,11,64,2
101.0,4,3,2,6,9,65,3
101.0,4,3,2,6,9,66,4
101.0,4,4,2,6,10,67,5
101.0,4,3,2,6,9,68,6
101.0,5,0,1,3,3,80,1
101.0,5,0,1,3,3,81,2
101.0,5,1,1,3,4,82,3
101.0,5,0,1,3,3,83,4
101.0,5,1,1,2,3,84,5
101.0,5,1,1,2,3,85,6
101.0,5,1,1,2,3,86,7
101.0,5,1,1,2,3,87,8
101.0,5,1,1,2,3,88,9
101.0,5,0,1,3,3,89,10
101.0,5,2,1,2,4,90,11
101.0,5,1,1,3,4,91,12
101.0,5,2,1,2,4,92,13
101.0,5,-2,1,3,1,93,14
104.0,1,1,0,2,3,0,1
104.0,1,1,0,2,3,1,2
104.0,1,1,1,3,4,2,1
104.0,1,2,1,3,5,3,2
104.0,1,1,1,3,4,4,3
104.0,1,3,2,6,9,5,1
104.0,1,4,2,7,11,6,2
104.0,1,3,2,5,8,7,3
104.0,1,1,0,2,3,8,1
104.0,1,1,0,2,3,9,2
104.0,1,1,0,2,3,10,3
104.0,2,1,0,2,3,20,4
104.0,2,1,0,2,3,21,5
104.0,2,1,0,2,3,22,6
104.0,2,2,2,6,8,23,1
104.0,2,3,2,7,10,24,2
104.0,2,4,2,7,11,25,3
104.0,2,3,2,7,10,26,4
104.0,2,3,2,7,10,27,5
104.0,2,1,1,3,4,28,1
104.0,3,1,1,3,4,40,2
104.0,3,2,2,6,8,41,1
104.0,3,2,1,2,4,42,1
104.0,3,2,1,2,4,43,2
104.0,3,1,1,3,4,44,3
104.0,3,2,1,2,4,45,4
104.0,3,4,2,7,11,46,1
104.0,3,4,2,7,11,47,2
104.0,3,1,1,3,4,48,1
104.0,3,2,1,2,4,49,2
104.0,4,1,0,2,3,60,1
104.0,4,0,0,2,2,61,2
104.0,4,3,0,2,5,62,3
104.0,4,3,2,7,10,63,1
104.0,4,3,2,6,9,64,2
104.0,4,4,2,6,10,65,3
104.0,4,3,2,7,10,66,4
104.0,4,3,2,7,10,67,5
104.0,4,0,2,7,7,68,6
104.0,5,1,1,2,3,80,1
104.0,5,0,1,3,3,81,2
104.0,5,1,1,2,3,82,3
104.0,5,1,1,2,3,83,4
104.0,5,1,1,2,3,84,5
104.0,5,1,1,2,3,85,6
104.0,5,1,1,2,3,86,7
104.0,5,0,1,3,3,87,8
104.0,5,1,1,3,4,88,9
104.0,5,0,1,3,3,89,10
104.0,5,0,1,3,3,90,11
104.0,5,1,1,2,3,91,12
104.0,5,2,1,2,4,92,13
104.0,5,1,1,2,3,93,14
105.0,1,1,0,2,3,0,1
105.0,1,0,0,2,2,1,2
105.0,1,-2,1,3,1,2,1
105.0,1,1,1,3,4,3,2
105.0,1,1,1,3,4,4,3
105.0,1,4,2,7,11,5,1
105.0,1,0,2,6,6,6,2
105.0,1,3,2,8,11,7,3
105.0,1,1,0,2,3,8,1
105.0,1,1,0,2,3,9,2
105.0,1,1,0,2,3,10,3
105.0,1,0,0,2,2,11,4
105.0,2,1,0,2,3,20,5
105.0,2,0,0,2,2,21,6
105.0,2,1,0,2,3,22,7
105.0,2,4,2,7,11,23,1
105.0,2,3,2,7,10,24,2
105.0,2,3,2,6,9,25,3
105.0,2,3,2,6,9,26,4
105.0,2,4,2,8,12,27,5
105.0,2,2,1,2,4,28,1
105.0,3,2,1,2,4,40,2
105.0,3,3,2,7,10,41,1
105.0,3,1,1,3,4,42,1
105.0,3,1,1,3,4,43,2
105.0,3,1,1,3,4,44,3
105.0,3,2,1,2,4,45,4
105.0,3,3,2,7,10,46,1
105.0,3,3,2,7,10,47,2
105.0,3,2,1,2,4,48,1
105.0,3,2,1,3,5,49,2
105.0,4,0,0,2,2,60,1
105.0,4,1,0,2,3,61,2
105.0,4,1,0,2,3,62,3
105.0,4,3,2,7,10,63,1
105.0,4,3,2,7,10,64,2
105.0,4,3,2,6,9,65,3
105.0,4,3,2,8,11,66,4
105.0,4,3,2,7,10,67,5
105.0,4,3,2,5,8,68,6
105.0,5,1,1,2,3,80,1
105.0,5,1,1,2,3,81,2
105.0,5,1,1,2,3,82,3
105.0,5,1,1,2,3,83,4
105.0,5,1,1,2,3,84,5
105.0,5,1,1,2,3,85,6
105.0,5,1,1,2,3,86,7
105.0,5,0,1,3,3,87,8
105.0,5,2,1,2,4,88,9
105.0,5,2,1,2,4,89,10
105.0,5,2,1,2,4,90,11
105.0,5,2,1,2,4,91,12
105.0,5,2,1,2,4,92,13
106.0,1,0,0,2,2,0,1
106.0,1,0,0,2,2,1,2
106.0,1,1,1,3,4,2,1
106.0,1,2,1,2,4,3,2
106.0,1,1,1,3,4,4,3
106.0,1,2,2,6,8,5,1
106.0,1,4,2,7,11,6,2
106.0,1,4,2,6,10,7,3
106.0,1,1,0,2,3,8,1
106.0,1,0,0,2,2,9,2
106.0,1,1,0,2,3,10,3
106.0,2,1,0,2,3,20,4
106.0,2,0,0,2,2,21,5
106.0,2,1,0,2,3,22,6
106.0,2,3,2,6,9,23,1
106.0,2,2,2,8,10,24,2
106.0,2,3,2,6,9,25,3
106.0,2,3,2,7,10,26,4
106.0,2,3,2,7,10,27,5
106.0,2,2,1,2,4,28,1
106.0,2,-5,2,7,2,29,1
106.0,3,1,1,2,3,40,1
106.0,3,0,2,7,7,41,1
106.0,3,1,1,2,3,42,1
106.0,3,0,1,3,3,43,2
106.0,3,1,1,2,3,44,3
106.0,3,1,1,2,3,45,4
106.0,3,1,2,6,7,46,1
106.0,3,1,2,6,7,47,2
106.0,3,2,1,2,4,48,1
106.0,3,2,1,2,4,49,2
106.0,3,4,2,6,10,50,1
106.0,4,1,0,2,3,60,1
106.0,4,1,0,2,3,61,2
106.0,4,1,0,2,3,62,3
106.0,4,3,2,7,10,63,1
106.0,4,4,2,7,11,64,2
106.0,4,4,2,7,11,65,3
106.0,4,3,2,7,10,66,4
106.0,4,4,2,6,10,67,5
106.0,4,-1,2,6,5,68,6
106.0,5,0,1,3,3,80,1
106.0,5,1,1,2,3,81,2
106.0,5,0,1,3,3,82,3
106.0,5,1,1,2,3,83,4
106.0,5,0,1,3,3,84,5
106.0,5,1,1,2,3,85,6
106.0,5,1,1,2,3,86,7
106.0,5,0,1,3,3,87,8
106.0,5,1,1,2,3,88,9
106.0,5,2,1,2,4,89,10
106.0,5,2,1,2,4,90,11
106.0,5,2,1,2,4,91,12
106.0,5,2,1,2,4,92,13
106.0,5,-1,1,2,1,93,14
107.0,1,-1,0,2,1,0,1
107.0,1,0,0,2,2,1,2
107.0,1,1,1,3,4,2,1
107.0,1,1,1,3,4,3,2
107.0,1,1,1,3,4,4,3
107.0,1,3,2,6,9,5,1
107.0,1,2,2,7,9,6,2
107.0,1,3,2,7,10,7,3
107.0,1,1,0,2,3,8,1
107.0,1,1,0,2,3,9,2
107.0,1,1,0,2,3,10,3
107.0,1,-1,0,2,1,11,4
107.0,2,0,0,2,2,20,5
107.0,2,0,0,2,2,21,6
107.0,2,0,0,2,2,22,7
107.0,2,2,2,7,9,23,1
107.0,2,3,2,7,10,24,2
107.0,2,3,2,7,10,25,3
107.0,2,3,2,7,10,26,4
107.0,2,3,2,7,10,27,5
107.0,2,1,1,3,4,28,1
107.0,2,-3,2,6,3,29,1
107.0,3,1,1,2,3,40,1
107.0,3,0,2,7,7,41,1
107.0,3,1,1,2,3,42,1
107.0,3,1,1,2,3,43,2
107.0,3,1,1,2,3,44,3
107.0,3,1,1,3,4,45,4
107.0,3,3,2,7,10,46,1
107.0,3,3,2,7,10,47,2
107.0,3,1,1,3,4,48,1
107.0,3,2,1,3,5,49,2
107.0,3,-2,2,7,5,50,1
107.0,4,0,0,2,2,60,1
107.0,4,0,0,2,2,61,2
107.0,4,0,0,2,2,62,3
107.0,4,0,2,8,8,63,1
107.0,4,0,2,7,7,64,2
107.0,4,0,2,6,6,65,3
107.0,4,0,2,7,7,66,4
107.0,4,4,2,5,9,67,5
107.0,4,3,2,7,10,68,6
107.0,4,0,0,2,2,69,1
107.0,4,0,0,2,2,70,2
107.0,5,2,1,3,5,80,1
107.0,5,2,1,2,4,81,2
107.0,5,2,1,2,4,82,3
107.0,5,2,1,2,4,83,4
107.0,5,1,1,3,4,84,5
107.0,5,2,1,2,4,85,6
107.0,5,2,1,2,4,86,7
107.0,5,2,1,2,4,87,8
107.0,5,2,1,2,4,88,9
107.0,5,2,1,2,4,89,10
107.0,5,2,1,2,4,90,11
107.0,5,2,1,2,4,91,12
108.0,1,-1,0,2,1,0,1
108.0,1,1,0,2,3,1,2
108.0,1,2,1,3,5,2,1
108.0,1,1,1,3,4,3,2
108.0,1,1,1,3,4,4,3
108.0,1,3,2,7,10,5,1
108.0,1,2,2,6,8,6,2
108.0,1,3,2,6,9,7,3
108.0,1,1,0,2,3,8,1
108.0,1,1,0,2,3,9,2
108.0,1,0,0,2,2,10,3
108.0,1,-1,0,2,1,11,4
108.0,2,0,0,2,2,20,5
108.0,2,0,0,2,2,21,6
108.0,2,0,0,2,2,22,7
108.0,2,0,2,6,6,23,1
108.0,2,1,2,7,8,24,2
108.0,2,3,2,7,10,25,3
108.0,2,3,2,8,11,26,4
108.0,2,4,2,5,9,27,5
108.0,2,2,1,2,4,28,1
108.0,2,2,2,6,8,29,1
108.0,3,1,1,2,3,40,1
108.0,3,0,2,7,7,41,1
108.0,3,1,1,2,3,42,1
108.0,3,1,1,2,3,43,2
108.0,3,1,1,3,4,44,3
108.0,3,2,1,2,4,45,4
108.0,3,3,2,6,9,46,1
108.0,3,3,2,6,9,47,2
108.0,3,2,1,2,4,48,1
108.0,3,2,1,2,4,49,2
108.0,3,-1,2,8,7,50,1
108.0,4,0,0,2,2,60,1
108.0,4,0,0,2,2,61,2
108.0,4,0,0,2,2,62,3
108.0,4,0,2,8,8,63,1
108.0,4,0,2,7,7,64,2
108.0,4,1,2,7,8,65,3
108.0,4,2,2,6,8,66,4
108.0,4,2,2,7,9,67,5
108.0,4,4,2,7,11,68,6
108.0,4,1,0,2,3,69,1
108.0,5,2,1,2,4,80,1
108.0,5,1,1,3,4,81,2
108.0,5,2,1,2,4,82,3
108.0,5,2,1,2,4,83,4
108.0,5,2,1,2,4,84,5
108.0,5,2,1,2,4,85,6
108.0,5,2,1,2,4,86,7
108.0,5,2,1,2,4,87,8
108.0,5,2,1,2,4,88,9
108.0,5,2,1,2,4,89,10
108.0,5,2,1,3,5,90,11
108.0,5,1,1,3,4,91,12
110.0,1,-1,0,2,1,0,1
110.0,1,0,0,2,2,1,2
110.0,1,1,1,3,4,2,1
110.0,1,1,1,3,4,3,2
110.0,1,1,1,3,4,4,3
110.0,1,3,2,8,11,5,1
110.0,1,4,2,6,10,6,2
110.0,1,3,2,6,9,7,3
110.0,1,2,0,2,4,8,1
110.0,1,0,0,2,2,9,2
110.0,1,0,0,2,2,10,3
110.0,2,0,0,2,2,20,4
110.0,2,2,0,2,4,21,5
110.0,2,1,0,2,3,22,6
110.0,2,4,2,7,11,23,1
110.0,2,4,2,6,10,24,2
110.0,2,3,2,8,11,25,3
110.0,2,3,2,7,10,26,4
110.0,2,3,2,6,9,27,5
110.0,2,2,1,3,5,28,1
110.0,3,2,1,2,4,40,2
110.0,3,4,2,7,11,41,1
110.0,3,1,1,3,4,42,1
110.0,3,2,1,2,4,43,2
110.0,3,2,1,2,4,44,3
110.0,3,1,1,3,4,45,4
110.0,3,2,2,8,10,46,1
110.0,3,2,2,7,9,47,2
110.0,3,1,1,2,3,48,1
110.0,3,1,1,2,3,49,2
110.0,3,-5,2,6,1,50,1
110.0,4,0,0,2,2,60,1
110.0,4,0,0,2,2,61,2
110.0,4,0,0,2,2,62,3
110.0,4,0,2,7,7,63,1
110.0,4,0,2,7,7,64,2
110.0,4,0,2,6,6,65,3
110.0,4,3,2,5,8,66,4
110.0,4,4,2,6,10,67,5
110.0,4,3,2,6,9,68,6
110.0,4,1,0,2,3,69,1
110.0,4,-1,0,2,1,70,2
110.0,5,1,1,2,3,80,1
110.0,5,1,1,2,3,81,2
110.0,5,0,1,3,3,82,3
110.0,5,0,1,3,3,83,4
110.0,5,1,1,2,3,84,5
110.0,5,0,1,3,3,85,6
110.0,5,1,1,2,3,86,7
110.0,5,1,1,2,3,87,8
110.0,5,2,1,2,4,88,9
110.0,5,2,1,2,4,89,10
110.0,5,1,1,3,4,90,11
110.0,5,2,1,2,4,91,12
110.0,5,2,1,2,4,92,13
112.0,1,1,0,2,3,0,1
112.0,1,1,0,2,3,1,2
112.0,1,2,1,3,5,2,1
112.0,1,1,1,3,4,3,2
112.0,1,1,1,3,4,4,3
112.0,1,2,2,7,9,5,1
112.0,1,3,2,7,10,6,2
112.0,1,3,2,6,9,7,3
112.0,1,1,0,2,3,8,1
112.0,1,0,0,2,2,9,2
112.0,1,0,0,2,2,10,3
112.0,2,0,0,2,2,20,4
112.0,2,0,0,2,2,21,5
112.0,2,0,0,2,2,22,6
112.0,2,2,2,7,9,23,1
112.0,2,3,2,7,10,24,2
112.0,2,3,2,6,9,25,3
112.0,2,2,2,7,9,26,4
112.0,2,4,2,5,9,27,5
112.0,2,2,1,2,4,28,1
112.0,2,0,2,6,6,29,1
112.0,3,0,1,3,3,40,1
112.0,3,0,2,6,6,41,1
112.0,3,0,1,3,3,42,1
112.0,3,1,1,2,3,43,2
112.0,3,1,1,2,3,44,3
112.0,3,1,1,2,3,45,4
112.0,3,2,2,7,9,46,1
112.0,3,4,2,5,9,47,2
112.0,3,1,1,3,4,48,1
112.0,3,2,1,3,5,49,2
112.0,3,3,2,6,9,50,1
112.0,4,0,0,2,2,60,1
112.0,4,0,0,2,2,61,2
112.0,4,0,0,2,2,62,3
112.0,4,3,2,7,10,63,1
112.0,4,4,2,7,11,64,2
112.0,4,3,2,6,9,65,3
112.0,4,3,2,6,9,66,4
112.0,4,2,2,6,8,67,5
112.0,4,4,2,7,11,68,6
112.0,5,2,1,2,4,80,1
112.0,5,2,1,2,4,81,2
112.0,5,2,1,2,4,82,3
112.0,5,2,1,2,4,83,4
112.0,5,2,1,2,4,84,5
112.0,5,2,1,2,4,85,6
112.0,5,2,1,2,4,86,7
112.0,5,3,1,2,5,87,8
112.0,5,2,1,2,4,88,9
112.0,5,2,1,2,4,89,10
112.0,5,1,1,3,4,90,11
112.0,5,2,1,2,4,91,12
113.0,1,-1,0,2,1,0,1
113.0,1,0,0,2,2,1,2
113.0,1,1,1,3,4,2,1
113.0,1,1,1,3,4,3,2
113.0,1,1,1,3,4,4,3
113.0,1,3,2,6,9,5,1
113.0,1,3,2,6,9,6,2
113.0,1,3,2,8,11,7,3
113.0,1,1,0,2,3,8,1
113.0,1,1,0,2,3,9,2
113.0,1,1,0,2,3,10,3
113.0,2,1,0,2,3,20,4
113.0,2,1,0,2,3,21,5
113.0,2,1,0,2,3,22,6
113.0,2,3,2,6,9,23,1
113.0,2,2,2,8,10,24,2
113.0,2,2,2,7,9,25,3
113.0,2,4,2,6,10,26,4
113.0,2,3,2,7,10,27,5
113.0,2,2,1,2,4,28,1
113.0,2,-6,2,7,1,29,1
113.0,3,1,1,2,3,40,1
113.0,3,0,2,6,6,41,1
113.0,3,0,1,3,3,42,1
113.0,3,1,1,2,3,43,2
113.0,3,0,1,3,3,44,3
113.0,3,1,1,2,3,45,4
113.0,3,0,2,7,7,46,1
113.0,3,0,2,7,7,47,2
113.0,3,1,1,2,3,48,1
113.0,3,1,1,2,3,49,2
113.0,3,4,2,6,10,50,1
113.0,3,-4,2,6,2,51,2
113.0,4,0,0,2,2,60,1
113.0,4,0,0,2,2,61,2
113.0,4,0,0,2,2,62,3
113.0,4,0,2,7,7,63,1
113.0,4,0,2,7,7,64,2
113.0,4,0,2,6,6,65,3
113.0,4,2,2,7,9,66,4
113.0,4,3,2,6,9,67,5
113.0,4,4,2,6,10,68,6
113.0,4,1,0,2,3,69,1
113.0,5,2,1,2,4,80,1
113.0,5,2,1,2,4,81,2
113.0,5,2,1,2,4,82,3
113.0,5,2,1,2,4,83,4
113.0,5,2,1,2,4,84,5
113.0,5,2,1,2,4,85,6
113.0,5,1,1,3,4,86,7
113.0,5,2,1,2,4,87,8
113.0,5,3,1,2,5,88,9
113.0,5,2,1,2,4,89,10
113.0,5,2,1,2,4,90,11
113.0,5,2,1,2,4,91,12
115.0,1,0,0,2,2,0,1
115.0,1,1,0,2,3,1,2
115.0,1,-2,1,3,1,2,1
115.0,1,-2,1,3,1,3,2
115.0,1,1,1,3,4,4,3
115.0,1,4,2,7,11,5,1
115.0,1,4,2,7,11,6,2
115.0,1,4,2,6,10,7,3
115.0,1,1,0,2,3,8,1
115.0,1,1,0,2,3,9,2
115.0,1,1,0,2,3,10,3
115.0,1,-1,0,2,1,11,4
115.0,2,0,0,2,2,20,5
115.0,2,0,0,2,2,21,6
115.0,2,0,0,2,2,22,7
115.0,2,0,2,7,7,23,1
115.0,2,-1,2,7,6,24,2
115.0,2,4,2,6,10,25,3
115.0,2,4,2,7,11,26,4
115.0,2,4,2,7,11,27,5
115.0,2,2,1,2,4,28,1
115.0,2,0,2,7,7,29,1
115.0,3,0,1,3,3,40,1
115.0,3,0,2,7,7,41,1
115.0,3,1,1,2,3,42,1
115.0,3,1,1,2,3,43,2
115.0,3,1,1,3,4,44,3
115.0,3,2,1,2,4,45,4
115.0,3,3,2,6,9,46,1
115.0,3,3,2,7,10,47,2
115.0,3,2,1,2,4,48,1
115.0,3,2,1,2,4,49,2
115.0,3,-1,2,7,6,50,1
115.0,4,0,0,2,2,60,1
115.0,4,0,0,2,2,61,2
115.0,4,0,0,2,2,62,3
115.0,4,0,2,7,7,63,1
115.0,4,0,2,7,7,64,2
115.0,4,3,2,6,9,65,3
115.0,4,1,2,7,8,66,4
115.0,4,2,2,5,7,67,5
115.0,4,3,2,5,8,68,6
115.0,4,1,0,2,3,69,1
115.0,4,0,0,2,2,70,2
115.0,5,1,1,2,3,80,1
115.0,5,1,1,2,3,81,2
115.0,5,0,1,3,3,82,3
115.0,5,0,1,3,3,83,4
115.0,5,1,1,2,3,84,5
115.0,5,1,1,2,3,85,6
115.0,5,1,1,2,3,86,7
115.0,5,1,1,2,3,87,8
115.0,5,2,1,2,4,88,9
115.0,5,2,1,2,4,89,10
115.0,5,1,1,3,4,90,11
115.0,5,1,1,3,4,91,12
115.0,5,2,1,2,4,92,13
116.0,1,1,0,2,3,0,1
116.0,1,1,0,2,3,1,2
116.0,1,1,1,3,4,2,1
116.0,1,1,1,3,4,3,2
116.0,1,1,1,3,4,4,3
116.0,1,2,2,6,8,5,1
116.0,1,4,2,7,11,6,2
116.0,1,4,2,6,10,7,3
116.0,1,0,0,2,2,8,1
116.0,1,4,0,2,6,9,2
116.0,1,0,0,2,2,10,3
116.0,2,0,0,2,2,20,4
116.0,2,0,0,2,2,21,5
116.0,2,0,0,2,2,22,6
116.0,2,0,2,7,7,23,1
116.0,2,1,2,8,9,24,2
116.0,2,2,2,7,9,25,3
116.0,2,4,2,6,10,26,4
116.0,2,4,2,6,10,27,5
116.0,2,1,1,3,4,28,1
116.0,2,0,2,7,7,29,1
116.0,3,1,1,2,3,40,1
116.0,3,0,2,6,6,41,1
116.0,3,1,1,2,3,42,1
116.0,3,1,1,2,3,43,2
116.0,3,0,1,3,3,44,3
116.0,3,2,1,2,4,45,4
116.0,3,4,2,6,10,46,1
116.0,3,4,2,6,10,47,2
116.0,3,2,1,2,4,48,1
116.0,3,1,1,3,4,49,2
116.0,3,1,2,6,7,50,1
116.0,4,0,0,2,2,60,1
116.0,4,0,0,2,2,61,2
116.0,4,0,0,2,2,62,3
116.0,4,1,2,7,8,63,1
116.0,4,1,2,7,8,64,2
116.0,4,0,2,7,7,65,3
116.0,4,4,2,6,10,66,4
116.0,4,4,2,7,11,67,5
116.0,4,4,2,6,10,68,6
116.0,4,0,0,2,2,69,1
116.0,5,1,1,2,3,80,1
116.0,5,1,1,2,3,81,2
116.0,5,1,1,2,3,82,3
116.0,5,1,1,2,3,83,4
116.0,5,1,1,2,3,84,5
116.0,5,1,1,2,3,85,6
116.0,5,1,1,2,3,86,7
116.0,5,1,1,2,3,87,8
116.0,5,1,1,2,3,88,9
116.0,5,1,1,2,3,89,10
116.0,5,2,1,2,4,90,11
116.0,5,2,1,2,4,91,12
116.0,5,2,1,2,4,92,13
116.0,5,0,1,2,2,93,14
117.0,1,-1,0,2,1,0,1
117.0,1,-1,0,2,1,1,2
117.0,1,-2,1,3,1,2,1
117.0,1,-2,1,3,1,3,2
117.0,1,-2,1,3,1,4,3
117.0,1,-8,2,9,1,5,1
117.0,1,-6,2,7,1,6,2
117.0,1,2,2,8,10,7,3
117.0,1,1,0,2,3,8,1
117.0,1,0,0,2,2,9,2
117.0,1,1,0,2,3,10,3
117.0,1,0,0,2,2,11,4
117.0,1,1,0,2,3,12,5
117.0,1,3,2,8,11,13,1
117.0,2,4,0,2,6,20,1
117.0,2,0,0,2,2,21,2
117.0,2,1,0,2,3,22,3
117.0,2,2,2,8,10,23,1
117.0,2,3,2,8,11,24,2
117.0,2,3,2,6,9,25,3
117.0,2,2,2,8,10,26,4
117.0,2,2,2,6,8,27,5
117.0,2,1,1,3,4,28,1
117.0,3,2,1,2,4,40,2
117.0,3,3,2,6,9,41,1
117.0,3,1,1,3,4,42,1
117.0,3,2,1,2,4,43,2
117.0,3,2,1,2,4,44,3
117.0,3,2,1,3,5,45,4
117.0,3,4,2,7,11,46,1
117.0,3,3,2,8,11,47,2
117.0,3,2,1,2,4,48,1
117.0,3,1,1,3,4,49,2
117.0,4,0,0,2,2,60,1
117.0,4,0,0,2,2,61,2
117.0,4,0,0,2,2,62,3
117.0,4,2,2,8,10,63,1
117.0,4,3,2,7,10,64,2
117.0,4,4,2,6,10,65,3
117.0,4,3,2,7,10,66,4
117.0,4,2,2,8,10,67,5
117.0,4,2,2,6,8,68,6
117.0,5,1,1,3,4,80,1
117.0,5,2,1,2,4,81,2
117.0,5,2,1,2,4,82,3
117.0,5,2,1,2,4,83,4
117.0,5,1,1,3,4,84,5
117.0,5,2,1,2,4,85,6
117.0,5,2,1,2,4,86,7
117.0,5,2,1,2,4,87,8
117.0,5,2,1,2,4,88,9
117.0,5,1,1,3,4,89,10
117.0,5,2,1,2,4,90,11
117.0,5,1,1,3,4,91,12
117.0,5,-2,1,3,1,92,13
119.0,1,1,0,2,3,0,1
119.0,1,1,0,2,3,1,2
119.0,1,2,1,2,4,2,1
119.0,1,1,1,3,4,3,2
119.0,1,1,1,3,4,4,3
119.0,1,3,2,6,9,5,1
119.0,1,4,2,8,12,6,2
119.0,1,4,2,6,10,7,3
119.0,1,0,0,2,2,8,1
119.0,1,1,0,2,3,9,2
119.0,1,1,0,2,3,10,3
119.0,2,1,0,2,3,20,4
119.0,2,0,0,2,2,21,5
119.0,2,1,0,2,3,22,6
119.0,2,4,2,7,11,23,1
119.0,2,3,2,7,10,24,2
119.0,2,2,2,7,9,25,3
119.0,2,3,2,7,10,26,4
119.0,2,4,2,5,9,27,5
119.0,2,2,1,2,4,28,1
119.0,2,-5,2,6,1,29,1
119.0,3,0,1,3,3,40,1
119.0,3,0,2,7,7,41,1
119.0,3,0,1,3,3,42,1
119.0,3,1,1,2,3,43,2
119.0,3,0,1,3,3,44,3
119.0,3,2,1,2,4,45,4
119.0,3,2,2,8,10,46,1
119.0,3,3,2,6,9,47,2
119.0,3,2,1,2,4,48,1
119.0,3,2,1,2,4,49,2
119.0,3,1,2,6,7,50,1
119.0,4,0,0,2,2,60,1
119.0,4,0,0,2,2,61,2
119.0,4,0,0,2,2,62,3
119.0,4,0,2,7,7,63,1
119.0,4,0,2,6,6,64,2
119.0,4,1,2,6,7,65,3
119.0,4,0,2,7,7,66,4
119.0,4,3,2,5,8,67,5
119.0,4,4,2,6,10,68,6
119.0,4,0,0,2,2,69,1
119.0,4,1,0,2,3,70,2
119.0,5,2,1,2,4,80,1
119.0,5,1,1,3,4,81,2
119.0,5,2,1,2,4,82,3
119.0,5,1,1,3,4,83,4
119.0,5,1,1,3,4,84,5
119.0,5,2,1,2,4,85,6
119.0,5,2,1,2,4,86,7
119.0,5,2,1,2,4,87,8
119.0,5,2,1,2,4,88,9
119.0,5,2,1,2,4,89,10
119.0,5,2,1,2,4,90,11
119.0,5,2,1,2,4,91,12
119.0,5,-2,1,3,1,92,13
120.0,1,0,0,2,2,0,1
120.0,1,0,0,2,2,1,2
120.0,1,1,1,3,4,2,1
120.0,1,1,1,3,4,3,2
120.0,1,1,1,3,4,4,3
120.0,1,3,2,7,10,5,1
120.0,1,3,2,7,10,6,2
120.0,1,3,2,7,10,7,3
120.0,1,0,0,2,2,8,1
120.0,1,2,0,2,4,9,2
120.0,1,1,0,2,3,10,3
120.0,2,1,0,2,3,20,4
120.0,2,1,0,2,3,21,5
120.0,2,1,0,2,3,22,6
120.0,2,3,2,5,8,23,1
120.0,2,2,2,7,9,24,2
120.0,2,3,2,6,9,25,3
120.0,2,3,2,7,10,26,4
120.0,2,3,2,6,9,27,5
120.0,2,1,1,3,4,28,1
120.0,2,-3,2,7,4,29,1
120.0,3,1,1,2,3,40,1
120.0,3,0,2,6,6,41,1
120.0,3,0,1,3,3,42,1
120.0,3,0,1,3,3,43,2
120.0,3,1,1,2,3,44,3
120.0,3,1,1,2,3,45,4
120.0,3,4,2,6,10,46,1
120.0,3,4,2,6,10,47,2
120.0,3,1,1,3,4,48,1
120.0,3,2,1,2,4,49,2
120.0,3,0,2,8,8,50,1
120.0,4,0,0,2,2,60,1
120.0,4,0,0,2,2,61,2
120.0,4,0,0,2,2,62,3
120.0,4,0,2,6,6,63,1
120.0,4,0,2,8,8,64,2
120.0,4,3,2,6,9,65,3
120.0,4,3,2,6,9,66,4
120.0,4,5,2,5,10,67,5
120.0,4,4,2,8,12,68,6
120.0,4,0,0,2,2,69,1
120.0,5,2,1,2,4,80,1
120.0,5,2,1,2,4,81,2
120.0,5,1,1,3,4,82,3
120.0,5,2,1,2,4,83,4
120.0,5,2,1,2,4,84,5
120.0,5,2,1,2,4,85,6
120.0,5,2,1,2,4,86,7
120.0,5,2,1,3,5,87,8
120.0,5,2,1,2,4,88,9
120.0,5,1,1,3,4,89,10
120.0,5,2,1,2,4,90,11
120.0,5,3,1,2,5,91,12
121.0,1,0,0,2,2,0,1
121.0,1,0,0,2,2,1,2
121.0,1,1,1,3,4,2,1
121.0,1,1,1,3,4,3,2
121.0,1,1,1,3,4,4,3
121.0,1,2,2,7,9,5,1
121.0,1,4,2,6,10,6,2
121.0,1,3,2,7,10,7,3
121.0,1,1,0,2,3,8,1
121.0,1,0,0,2,2,9,2
121.0,1,0,0,2,2,10,3
121.0,1,-1,0,2,1,11,4
121.0,2,0,0,2,2,20,5
121.0,2,0,0,2,2,21,6
121.0,2,0,0,2,2,22,7
121.0,2,-1,2,8,7,23,1
121.0,2,-1,2,8,7,24,2
121.0,2,4,2,7,11,25,3
121.0,2,4,2,6,10,26,4
121.0,2,2,2,8,10,27,5
121.0,2,2,1,2,4,28,1
121.0,2,1,2,6,7,29,1
121.0,3,1,1,2,3,40,1
121.0,3,0,2,5,5,41,1
121.0,3,1,1,2,3,42,1
121.0,3,1,1,2,3,43,2
121.0,3,1,1,2,3,44,3
121.0,3,0,1,3,3,45,4
121.0,3,4,2,7,11,46,1
121.0,3,4,2,6,10,47,2
121.0,3,2,1,2,4,48,1
121.0,3,2,1,2,4,49,2
121.0,3,2,2,6,8,50,1
121.0,4,0,0,2,2,60,1
121.0,4,0,0,2,2,61,2
121.0,4,0,0,2,2,62,3
121.0,4,1,2,5,6,63,1
121.0,4,0,2,7,7,64,2
121.0,4,0,2,5,5,65,3
121.0,4,3,2,6,9,66,4
121.0,4,3,2,6,9,67,5
121.0,4,3,2,5,8,68,6
121.0,4,0,0,2,2,69,1
121.0,4,0,0,2,2,70,2
121.0,5,1,1,2,3,80,1
121.0,5,1,1,3,4,81,2
121.0,5,1,1,2,3,82,3
121.0,5,2,1,2,4,83,4
121.0,5,2,1,2,4,84,5
121.0,5,1,1,3,4,85,6
121.0,5,2,1,2,4,86,7
121.0,5,2,1,2,4,87,8
121.0,5,2,1,2,4,88,9
121.0,5,2,1,2,4,89,10
121.0,5,1,1,3,4,90,11
121.0,5,2,1,2,4,91,12
121.0,5,1,1,2,3,92,13
123.0,1,1,0,2,3,0,1
123.0,1,1,0,2,3,1,2
123.0,1,2,1,3,5,2,1
123.0,1,1,1,3,4,3,2
123.0,1,-2,1,3,1,4,3
123.0,1,-7,2,8,1,5,1
123.0,1,-7,2,8,1,6,2
123.0,1,3,2,7,10,7,3
123.0,1,0,0,2,2,8,1
123.0,1,0,0,2,2,9,2
123.0,1,1,0,2,3,10,3
123.0,1,1,0,2,3,11,4
123.0,1,0,0,2,2,12,5
123.0,1,-3,2,7,4,13,1
123.0,2,0,0,2,2,20,1
123.0,2,0,0,2,2,21,2
123.0,2,0,0,2,2,22,3
123.0,2,-1,2,8,7,23,1
123.0,2,0,2,7,7,24,2
123.0,2,0,2,7,7,25,3
123.0,2,0,2,7,7,26,4
123.0,2,1,2,8,9,27,5
123.0,2,3,1,2,5,28,1
123.0,2,3,2,7,10,29,1
123.0,3,2,1,2,4,40,1
123.0,3,3,2,6,9,41,1
123.0,3,1,1,3,4,42,1
123.0,3,2,1,2,4,43,2
123.0,3,1,1,3,4,44,3
123.0,3,1,1,3,4,45,4
123.0,3,3,2,6,9,46,1
123.0,3,4,2,6,10,47,2
123.0,3,2,1,2,4,48,1
123.0,3,2,1,2,4,49,2
123.0,3,-6,2,7,1,50,1
123.0,4,0,0,2,2,60,1
123.0,4,0,0,2,2,61,2
123.0,4,0,0,2,2,62,3
123.0,4,-1,2,6,5,63,1
123.0,4,0,2,6,6,64,2
123.0,4,0,2,6,6,65,3
123.0,4,0,2,7,7,66,4
123.0,4,3,2,6,9,67,5
123.0,4,4,2,6,10,68,6
123.0,4,0,0,2,2,69,1
123.0,4,1,0,2,3,70,2
123.0,5,1,1,3,4,80,1
123.0,5,1,1,3,4,81,2
123.0,5,2,1,2,4,82,3
123.0,5,2,1,2,4,83,4
123.0,5,2,1,2,4,84,5
123.0,5,1,1,3,4,85,6
123.0,5,2,1,2,4,86,7
123.0,5,2,1,2,4,87,8
123.0,5,2,1,3,5,88,9
123.0,5,2,1,2,4,89,10
123.0,5,2,1,2,4,90,11
123.0,5,2,1,2,4,91,12
124.0,1,-1,0,2,1,0,1
124.0,1,-1,0,2,1,1,2
124.0,1,1,1,3,4,2,1
124.0,1,2,1,2,4,3,2
124.0,1,1,1,3,4,4,3
124.0,1,2,2,7,9,5,1
124.0,1,4,2,7,11,6,2
124.0,1,3,2,7,10,7,3
124.0,1,1,0,2,3,8,1
124.0,1,1,0,2,3,9,2
124.0,1,0,0,2,2,10,3
124.0,1,-1,0,2,1,11,4
124.0,2,0,0,2,2,20,5
124.0,2,0,0,2,2,21,6
124.0,2,0,0,2,2,22,7
124.0,2,-1,2,6,5,23,1
124.0,2,2,2,7,9,24,2
124.0,2,1,2,8,9,25,3
124.0,2,0,2,7,7,26,4
124.0,2,0,2,8,8,27,5
124.0,2,1,1,2,3,28,1
124.0,2,3,2,6,9,29,1
124.0,2,-5,2,6,1,30,2
124.0,3,1,1,2,3,40,1
124.0,3,0,2,6,6,41,1
124.0,3,0,1,3,3,42,1
124.0,3,1,1,2,3,43,2
124.0,3,1,1,2,3,44,3
124.0,3,1,1,2,3,45,4
124.0,3,0,2,6,6,46,1
124.0,3,3,2,6,9,47,2
124.0,3,2,1,3,5,48,1
124.0,3,2,1,2,4,49,2
124.0,3,3,2,6,9,50,1
124.0,4,1,0,2,3,60,1
124.0,4,0,0,2,2,61,2
124.0,4,0,0,2,2,62,3
124.0,4,3,2,6,9,63,1
124.0,4,5,2,6,11,64,2
124.0,4,4,2,7,11,65,3
124.0,4,3,2,6,9,66,4
124.0,4,3,2,7,10,67,5
124.0,4,4,2,5,9,68,6
124.0,5,3,1,2,5,80,1
124.0,5,2,1,2,4,81,2
124.0,5,2,1,2,4,82,3
124.0,5,3,1,2,5,83,4
124.0,5,2,1,2,4,84,5
124.0,5,2,1,2,4,85,6
124.0,5,2,1,2,4,86,7
124.0,5,2,1,2,4,87,8
124.0,5,2,1,2,4,88,9
124.0,5,2,1,2,4,89,10
124.0,5,2,1,2,4,90,11
124.0,5,2,1,2,4,91,12
126.0,1,1,0,2,3,0,1
126.0,1,1,0,2,3,1,2
126.0,1,1,1,3,4,2,1
126.0,1,3,1,3,6,3,2
126.0,1,1,1,3,4,4,3
126.0,1,3,2,7,10,5,1
126.0,1,2,2,7,9,6,2
126.0,1,2,2,7,9,7,3
126.0,1,1,0,2,3,8,1
126.0,1,0,0,2,2,9,2
126.0,1,0,0,2,2,10,3
126.0,2,1,0,2,3,20,4
126.0,2,0,0,2,2,21,5
126.0,2,1,0,2,3,22,6
126.0,2,3,2,8,11,23,1
126.0,2,3,2,7,10,24,2
126.0,2,4,2,7,11,25,3
126.0,2,2,2,8,10,26,4
126.0,2,3,2,7,10,27,5
126.0,2,2,1,2,4,28,1
126.0,3,2,1,2,4,40,2
126.0,3,4,2,6,10,41,1
126.0,3,1,1,3,4,42,1
126.0,3,2,1,2,4,43,2
126.0,3,2,1,2,4,44,3
126.0,3,1,1,3,4,45,4
126.0,3,4,2,7,11,46,1
126.0,3,4,2,7,11,47,2
126.0,3,1,1,3,4,48,1
126.0,3,2,1,2,4,49,2
126.0,4,0,0,2,2,60,1
126.0,4,1,0,2,3,61,2
126.0,4,1,0,2,3,62,3
126.0,4,4,2,6,10,63,1
126.0,4,4,2,7,11,64,2
126.0,4,3,2,6,9,65,3
126.0,4,4,2,6,10,66,4
126.0,4,4,2,6,10,67,5
126.0,4,1,2,7,8,68,6
126.0,5,1,1,2,3,80,1
126.0,5,1,1,2,3,81,2
126.0,5,0,1,3,3,82,3
126.0,5,1,1,2,3,83,4
126.0,5,1,1,2,3,84,5
126.0,5,1,1,2,3,85,6
126.0,5,1,1,2,3,86,7
126.0,5,1,1,2,3,87,8
126.0,5,1,1,2,3,88,9
126.0,5,1,1,2,3,89,10
126.0,5,1,1,2,3,90,11
126.0,5,2,1,2,4,91,12
126.0,5,3,1,2,5,92,13
126.0,5,-1,1,3,2,93,14
127.0,1,1,0,2,3,0,1
127.0,1,1,0,2,3,1,2
127.0,1,1,1,3,4,2,1
127.0,1,1,1,3,4,3,2
127.0,1,-2,1,3,1,4,3
127.0,1,-7,2,8,1,5,1
127.0,1,-6,2,7,1,6,2
127.0,1,-6,2,7,1,7,3
127.0,1,1,0,2,3,8,1
127.0,1,1,0,2,3,9,2
127.0,1,1,0,2,3,10,3
127.0,1,-1,0,2,1,11,4
127.0,1,-1,0,2,1,12,5
127.0,1,3,2,6,9,13,1
127.0,1,-4,2,6,2,14,2
127.0,2,0,0,2,2,20,1
127.0,2,0,0,2,2,21,2
127.0,2,0,0,2,2,22,3
127.0,2,2,2,8,10,23,1
127.0,2,2,2,6,8,24,2
127.0,2,3,2,7,10,25,3
127.0,2,3,2,7,10,26,4
127.0,2,3,2,7,10,27,5
127.0,2,2,1,2,4,28,1
127.0,2,-3,2,7,4,29,1
127.0,3,0,1,3,3,40,1
127.0,3,-1,2,7,6,41,1
127.0,3,1,1,2,3,42,1
127.0,3,0,1,3,3,43,2
127.0,3,1,1,2,3,44,3
127.0,3,1,1,3,4,45,4
127.0,3,3,2,8,11,46,1
127.0,3,1,2,7,8,47,2
127.0,3,1,1,2,3,48,1
127.0,3,0,1,3,3,49,2
127.0,3,0,2,6,6,50,1
127.0,4,0,0,2,2,60,1
127.0,4,0,0,2,2,61,2
127.0,4,0,0,2,2,62,3
127.0,4,4,2,7,11,63,1
127.0,4,3,2,7,10,64,2
127.0,4,3,2,7,10,65,3
127.0,4,3,2,8,11,66,4
127.0,4,3,2,6,9,67,5
127.0,4,3,2,6,9,68,6
127.0,5,2,1,2,4,80,1
127.0,5,2,1,2,4,81,2
127.0,5,2,1,2,4,82,3
127.0,5,2,1,2,4,83,4
127.0,5,2,1,2,4,84,5
127.0,5,2,1,2,4,85,6
127.0,5,1,1,3,4,86,7
127.0,5,2,1,2,4,87,8
127.0,5,2,1,2,4,88,9
127.0,5,2,1,2,4,89,10
127.0,5,2,1,3,5,90,11
127.0,5,2,1,2,4,91,12
128.0,1,1,0,2,3,0,1
128.0,1,1,0,2,3,1,2
128.0,1,1,1,3,4,2,1
128.0,1,1,1,3,4,3,2
128.0,1,2,1,2,4,4,3
128.0,1,2,2,8,10,5,1
128.0,1,3,2,5,8,6,2
128.0,1,2,2,7,9,7,3
128.0,1,1,0,2,3,8,1
128.0,1,0,0,2,2,9,2
128.0,1,3,0,2,5,10,3
128.0,2,1,0,2,3,20,4
128.0,2,0,0,2,2,21,5
128.0,2,1,0,2,3,22,6
128.0,2,2,2,7,9,23,1
128.0,2,3,2,7,10,24,2
128.0,2,3,2,7,10,25,3
128.0,2,4,2,6,10,26,4
128.0,2,3,2,5,8,27,5
128.0,2,1,1,3,4,28,1
128.0,2,-3,2,6,3,29,1
128.0,3,1,1,2,3,40,1
128.0,3,0,2,6,6,41,1
128.0,3,1,1,2,3,42,1
128.0,3,0,1,3,3,43,2
128.0,3,0,1,3,3,44,3
128.0,3,0,1,3,3,45,4
128.0,3,0,2,7,7,46,1
128.0,3,1,2,6,7,47,2
128.0,3,2,1,2,4,48,1
128.0,3,1,1,3,4,49,2
128.0,3,3,2,6,9,50,1
128.0,3,-6,2,7,1,51,2
128.0,4,0,0,2,2,60,1
128.0,4,0,0,2,2,61,2
128.0,4,0,0,2,2,62,3
128.0,4,-1,2,7,6,63,1
128.0,4,0,2,6,6,64,2
128.0,4,3,2,7,10,65,3
128.0,4,3,2,6,9,66,4
128.0,4,4,2,7,11,67,5
128.0,4,5,2,6,11,68,6
128.0,4,1,0,2,3,69,1
128.0,5,2,1,2,4,80,1
128.0,5,2,1,2,4,81,2
128.0,5,2,1,2,4,82,3
128.0,5,2,1,2,4,83,4
128.0,5,2,1,2,4,84,5
128.0,5,2,1,2,4,85,6
128.0,5,1,1,3,4,86,7
128.0,5,2,1,2,4,87,8
128.0,5,1,1,3,4,88,9
128.0,5,1,1,3,4,89,10
128.0,5,1,1,3,4,90,11
128.0,5,1,1,2,3,91,12
128.0,5,-1,1,3,2,92,13
132.0,1,0,0,2,2,0,1
132.0,1,0,0,2,2,1,2
132.0,1,1,1,3,4,2,1
132.0,1,1,1,3,4,3,2
132.0,1,1,1,3,4,4,3
132.0,1,2,2,7,9,5,1
132.0,1,4,2,7,11,6,2
132.0,1,4,2,7,11,7,3
132.0,1,1,0,2,3,8,1
132.0,1,1,0,2,3,9,2
132.0,1,0,0,2,2,10,3
132.0,2,1,0,2,3,20,4
132.0,2,1,0,2,3,21,5
132.0,2,1,0,2,3,22,6
132.0,2,3,2,6,9,23,1
132.0,2,4,2,6,10,24,2
132.0,2,2,2,6,8,25,3
132.0,2,3,2,7,10,26,4
132.0,2,3,2,6,9,27,5
132.0,2,1,1,3,4,28,1
132.0,2,-3,2,6,3,29,1
132.0,3,1,1,2,3,40,1
132.0,3,0,2,7,7,41,1
132.0,3,1,1,2,3,42,1
132.0,3,1,1,2,3,43,2
132.0,3,1,1,2,3,44,3
132.0,3,1,1,2,3,45,4
132.0,3,3,2,6,9,46,1
132.0,3,3,2,6,9,47,2
132.0,3,3,1,2,5,48,1
132.0,3,2,1,2,4,49,2
132.0,3,0,2,8,8,50,1
132.0,4,0,0,2,2,60,1
132.0,4,0,0,2,2,61,2
132.0,4,0,0,2,2,62,3
132.0,4,0,2,7,7,63,1
132.0,4,0,2,6,6,64,2
132.0,4,0,2,7,7,65,3
132.0,4,0,2,7,7,66,4
132.0,4,0,2,8,8,67,5
132.0,4,3,2,7,10,68,6
132.0,4,1,0,2,3,69,1
132.0,4,1,0,2,3,70,2
132.0,5,1,1,3,4,80,1
132.0,5,2,1,2,4,81,2
132.0,5,2,1,2,4,82,3
132.0,5,1,1,3,4,83,4
132.0,5,2,1,2,4,84,5
132.0,5,2,1,2,4,85,6
132.0,5,2,1,2,4,86,7
132.0,5,2,1,2,4,87,8
132.0,5,2,1,2,4,88,9
132.0,5,2,1,2,4,89,10
132.0,5,2,1,2,4,90,11
132.0,5,2,1,2,4,91,12
132.0,5,-2,1,3,1,92,13
134.0,1,1,0,2,3,0,1
134.0,1,1,0,2,3,1,2
134.0,1,1,1,3,4,2,1
134.0,1,1,1,3,4,3,2
134.0,1,1,1,3,4,4,3
134.0,1,3,2,8,11,5,1
134.0,1,3,2,6,9,6,2
134.0,1,3,2,7,10,7,3
134.0,1,2,0,2,4,8,1
134.0,1,1,0,2,3,9,2
134.0,1,0,0,2,2,10,3
134.0,2,0,0,2,2,20,4
134.0,2,0,0,2,2,21,5
134.0,2,0,0,2,2,22,6
134.0,2,2,2,7,9,23,1
134.0,2,1,2,8,9,24,2
134.0,2,-1,2,8,7,25,3
134.0,2,2,2,7,9,26,4
134.0,2,3,2,6,9,27,5
134.0,2,2,1,2,4,28,1
134.0,2,3,2,6,9,29,1
134.0,3,0,1,3,3,40,1
134.0,3,0,2,7,7,41,1
134.0,3,1,1,2,3,42,1
134.0,3,0,1,3,3,43,2
134.0,3,0,1,3,3,44,3
134.0,3,1,1,2,3,45,4
134.0,3,0,2,6,6,46,1
134.0,3,1,2,6,7,47,2
134.0,3,0,1,3,3,48,1
134.0,3,1,1,2,3,49,2
134.0,3,2,2,6,8,50,1
134.0,3,-3,2,7,4,51,2
134.0,4,0,0,2,2,60,1
134.0,4,0,0,2,2,61,2
134.0,4,0,0,2,2,62,3
134.0,4,0,2,7,7,63,1
134.0,4,0,2,7,7,64,2
134.0,4,0,2,7,7,65,3
134.0,4,3,2,6,9,66,4
134.0,4,4,2,6,10,67,5
134.0,4,4,2,6,10,68,6
134.0,4,1,0,2,3,69,1
134.0,5,1,1,3,4,80,1
134.0,5,2,1,2,4,81,2
134.0,5,2,1,2,4,82,3
134.0,5,1,1,3,4,83,4
134.0,5,2,1,2,4,84,5
134.0,5,2,1,3,5,85,6
134.0,5,2,1,2,4,86,7
134.0,5,2,1,2,4,87,8
134.0,5,2,1,2,4,88,9
134.0,5,2,1,2,4,89,10
134.0,5,2,1,2,4,90,11
134.0,5,2,1,2,4,91,12
135.0,1,1,0,2,3,0,1
135.0,1,1,0,2,3,1,2
135.0,1,2,1,3,5,2,1
135.0,1,2,1,3,5,3,2
135.0,1,1,1,3,4,4,3
135.0,1,3,2,7,10,5,1
135.0,1,2,2,7,9,6,2
135.0,1,3,2,5,8,7,3
135.0,1,1,0,2,3,8,1
135.0,1,0,0,2,2,9,2
135.0,1,0,0,2,2,10,3
135.0,2,0,0,2,2,20,4
135.0,2,0,0,2,2,21,5
135.0,2,0,0,2,2,22,6
135.0,2,0,2,8,8,23,1
135.0,2,2,2,7,9,24,2
135.0,2,0,2,7,7,25,3
135.0,2,0,2,7,7,26,4
135.0,2,0,2,6,6,27,5
135.0,2,1,1,2,3,28,1
135.0,2,3,2,8,11,29,1
135.0,3,2,1,2,4,40,1
135.0,3,3,2,7,10,41,1
135.0,3,2,1,2,4,42,1
135.0,3,1,1,3,4,43,2
135.0,3,2,1,2,4,44,3
135.0,3,2,1,2,4,45,4
135.0,3,4,2,7,11,46,1
135.0,3,3,2,7,10,47,2
135.0,3,3,1,2,5,48,1
135.0,3,2,1,2,4,49,2
135.0,4,1,0,2,3,60,1
135.0,4,1,0,2,3,61,2
135.0,4,1,0,2,3,62,3
135.0,4,3,2,6,9,63,1
135.0,4,4,2,5,9,64,2
135.0,4,3,2,5,8,65,3
135.0,4,3,2,8,11,66,4
135.0,4,2,2,5,7,67,5
135.0,4,4,2,7,11,68,6
135.0,5,1,1,3,4,80,1
135.0,5,2,1,2,4,81,2
135.0,5,2,1,2,4,82,3
135.0,5,2,1,2,4,83,4
135.0,5,2,1,2,4,84,5
135.0,5,2,1,2,4,85,6
135.0,5,2,1,2,4,86,7
135.0,5,2,1,2,4,87,8
135.0,5,2,1,2,4,88,9
135.0,5,2,1,2,4,89,10
135.0,5,2,1,2,4,90,11
135.0,5,2,1,2,4,91,12
135.0,5,-1,1,2,1,92,13
136.0,1,-1,0,2,1,0,1
136.0,1,1,0,2,3,1,2
136.0,1,1,1,3,4,2,1
136.0,1,1,1,3,4,3,2
136.0,1,1,1,3,4,4,3
136.0,1,2,2,6,8,5,1
136.0,1,3,2,6,9,6,2
136.0,1,3,2,6,9,7,3
136.0,1,1,0,2,3,8,1
136.0,1,0,0,2,2,9,2
136.0,1,0,0,2,2,10,3
136.0,1,1,0,2,3,11,4
136.0,2,0,0,2,2,20,5
136.0,2,1,0,2,3,21,6
136.0,2,0,0,2,2,22,7
136.0,2,2,2,5,7,23,1
136.0,2,1,2,7,8,24,2
136.0,2,0,2,7,7,25,3
136.0,2,3,2,7,10,26,4
136.0,2,3,2,7,10,27,5
136.0,2,1,1,3,4,28,1
136.0,2,2,2,7,9,29,1
136.0,3,2,1,2,4,40,1
136.0,3,4,2,6,10,41,1
136.0,3,2,1,2,4,42,1
136.0,3,2,1,2,4,43,2
136.0,3,2,1,2,4,44,3
136.0,3,2,1,2,4,45,4
136.0,3,3,2,6,9,46,1
136.0,3,3,2,6,9,47,2
136.0,3,2,1,2,4,48,1
136.0,3,2,1,2,4,49,2
136.0,3,-5,2,6,1,50,1
136.0,4,0,0,2,2,60,1
136.0,4,0,0,2,2,61,2
136.0,4,0,0,2,2,62,3
136.0,4,0,2,7,7,63,1
136.0,4,0,2,6,6,64,2
136.0,4,2,2,7,9,65,3
136.0,4,3,2,7,10,66,4
136.0,4,3,2,7,10,67,5
136.0,4,4,2,6,10,68,6
136.0,4,1,0,2,3,69,1
136.0,5,2,1,2,4,80,1
136.0,5,2,1,2,4,81,2
136.0,5,1,1,3,4,82,3
136.0,5,1,1,3,4,83,4
136.0,5,2,1,2,4,84,5
136.0,5,2,1,2,4,85,6
136.0,5,2,1,2,4,86,7
136.0,5,1,1,3,4,87,8
136.0,5,2,1,2,4,88,9
136.0,5,2,1,2,4,89,10
136.0,5,2,1,2,4,90,11
136.0,5,2,1,2,4,91,12
136.0,5,-1,1,2,1,92,13
137.0,1,1,0,2,3,0,1
137.0,1,0,0,2,2,1,2
137.0,1,-2,1,3,1,2,1
137.0,1,2,1,2,4,3,2
137.0,1,1,1,3,4,4,3
137.0,1,-6,2,7,1,5,1
137.0,1,-6,2,7,1,6,2
137.0,1,-7,2,8,1,7,3
137.0,1,-1,0,2,1,8,1
137.0,1,1,0,2,3,9,2
137.0,1,-1,0,2,1,10,3
137.0,1,0,0,2,2,11,4
137.0,1,-1,0,2,1,12,5
137.0,1,3,2,8,11,13,1
137.0,1,-3,2,7,4,14,2
137.0,2,0,0,2,2,20,1
137.0,2,0,0,2,2,21,2
137.0,2,0,0,2,2,22,3
137.0,2,3,2,8,11,23,1
137.0,2,3,2,6,9,24,2
137.0,2,3,2,8,11,25,3
137.0,2,3,2,7,10,26,4
137.0,2,2,2,8,10,27,5
137.0,2,2,1,2,4,28,1
137.0,2,-6,2,7,1,29,1
137.0,3,0,1,3,3,40,1
137.0,3,0,2,6,6,41,1
137.0,3,1,1,2,3,42,1
137.0,3,0,1,3,3,43,2
137.0,3,1,1,3,4,44,3
137.0,3,2,1,2,4,45,4
137.0,3,3,2,8,11,46,1
137.0,3,2,2,7,9,47,2
137.0,3,1,1,3,4,48,1
137.0,3,2,1,2,4,49,2
137.0,3,0,2,6,6,50,1
137.0,4,0,0,2,2,60,1
137.0,4,0,0,2,2,61,2
137.0,4,0,0,2,2,62,3
137.0,4,0,2,7,7,63,1
137.0,4,0,2,7,7,64,2
137.0,4,1,2,6,7,65,3
137.0,4,0,2,7,7,66,4
137.0,4,0,2,5,5,67,5
137.0,4,0,2,7,7,68,6
137.0,4,0,0,2,2,69,1
137.0,4,0,0,2,2,70,2
137.0,4,-4,2,7,3,71,1
137.0,5,1,1,2,3,80,1
137.0,5,0,1,3,3,81,2
137.0,5,1,1,2,3,82,3
137.0,5,1,1,2,3,83,4
137.0,5,1,1,2,3,84,5
137.0,5,1,1,2,3,85,6
137.0,5,1,1,2,3,86,7
137.0,5,1,1,2,3,87,8
137.0,5,1,1,2,3,88,9
137.0,5,0,1,3,3,89,10
137.0,5,2,1,2,4,90,11
137.0,5,2,1,2,4,91,12
137.0,5,2,1,2,4,92,13
137.0,5,0,1,2,2,93,14
138.0,1,0,0,2,2,0,1
138.0,1,0,0,2,2,1,2
138.0,1,0,1,3,3,2,1
138.0,1,0,1,3,3,3,2
138.0,1,1,1,3,4,4,3
138.0,1,2,2,7,9,5,1
138.0,1,3,2,6,9,6,2
138.0,1,3,2,6,9,7,3
138.0,1,1,0,2,3,8,1
138.0,1,1,0,2,3,9,2
138.0,1,1,0,2,3,10,3
138.0,1,1,0,2,3,11,4
138.0,2,1,0,2,3,20,5
138.0,2,1,0,2,3,21,6
138.0,2,0,0,2,2,22,7
138.0,2,4,2,7,11,23,1
138.0,2,3,2,6,9,24,2
138.0,2,2,2,6,8,25,3
138.0,2,3,2,6,9,26,4
138.0,2,2,2,8,10,27,5
138.0,2,2,1,2,4,28,1
138.0,2,-4,2,7,3,29,1
138.0,3,1,1,2,3,40,1
138.0,3,0,2,7,7,41,1
138.0,3,0,1,3,3,42,1
138.0,3,1,1,2,3,43,2
138.0,3,1,1,2,3,44,3
138.0,3,1,1,2,3,45,4
138.0,3,3,2,6,9,46,1
138.0,3,2,2,5,7,47,2
138.0,3,1,1,3,4,48,1
138.0,3,1,1,3,4,49,2
138.0,3,3,2,7,10,50,1
138.0,4,1,0,2,3,60,1
138.0,4,1,0,2,3,61,2
138.0,4,1,0,2,3,62,3
138.0,4,3,2,7,10,63,1
138.0,4,3,2,6,9,64,2
138.0,4,2,2,8,10,65,3
138.0,4,4,2,7,11,66,4
138.0,4,3,2,7,10,67,5
138.0,4,0,2,7,7,68,6
138.0,5,1,1,2,3,80,1
138.0,5,1,1,2,3,81,2
138.0,5,0,1,3,3,82,3
138.0,5,1,1,2,3,83,4
138.0,5,0,1,3,3,84,5
138.0,5,0,1,3,3,85,6
138.0,5,0,1,3,3,86,7
138.0,5,0,1,3,3,87,8
138.0,5,2,1,2,4,88,9
138.0,5,2,1,2,4,89,10
138.0,5,1,1,3,4,90,11
138.0,5,2,1,3,5,91,12
138.0,5,1,1,3,4,92,13
141.0,1,0,0,2,2,0,1
141.0,1,0,0,2,2,1,2
141.0,1,3,1,2,5,2,1
141.0,1,1,1,3,4,3,2
141.0,1,1,1,3,4,4,3
141.0,1,2,2,7,9,5,1
141.0,1,3,2,7,10,6,2
141.0,1,4,2,7,11,7,3
141.0,1,2,0,2,4,8,1
141.0,1,0,0,2,2,9,2
141.0,1,1,0,2,3,10,3
141.0,2,0,0,2,2,20,4
141.0,2,0,0,2,2,21,5
141.0,2,0,0,2,2,22,6
141.0,2,4,2,6,10,23,1
141.0,2,3,2,6,9,24,2
141.0,2,4,2,6,10,25,3
141.0,2,3,2,7,10,26,4
141.0,2,4,2,6,10,27,5
141.0,2,2,1,2,4,28,1
141.0,2,-3,2,6,3,29,1
141.0,3,1,1,2,3,40,1
141.0,3,0,2,7,7,41,1
141.0,3,0,1,3,3,42,1
141.0,3,1,1,2,3,43,2
141.0,3,1,1,2,3,44,3
141.0,3,1,1,2,3,45,4
141.0,3,0,2,7,7,46,1
141.0,3,3,2,6,9,47,2
141.0,3,2,1,2,4,48,1
141.0,3,2,1,2,4,49,2
141.0,3,3,2,6,9,50,1
141.0,4,1,0,2,3,60,1
141.0,4,1,0,2,3,61,2
141.0,4,1,0,2,3,62,3
141.0,4,3,2,7,10,63,1
141.0,4,4,2,7,11,64,2
141.0,4,3,2,7,10,65,3
141.0,4,5,2,6,11,66,4
141.0,4,4,2,6,10,67,5
141.0,4,-1,2,6,5,68,6
141.0,5,1,1,2,3,80,1
141.0,5,1,1,2,3,81,2
141.0,5,1,1,2,3,82,3
141.0,5,1,1,2,3,83,4
141.0,5,1,1,2,3,84,5
141.0,5,1,1,2,3,85,6
141.0,5,0,1,3,3,86,7
141.0,5,1,1,2,3,87,8
141.0,5,1,1,2,3,88,9
141.0,5,2,1,2,4,89,10
141.0,5,2,1,2,4,90,11
141.0,5,2,1,2,4,91,12
141.0,5,2,1,2,4,92,13
141.0,5,-1,1,2,1,93,14
142.0,1,-1,0,2,1,0,1
142.0,1,-1,0,2,1,1,2
142.0,1,-2,1,3,1,2,1
142.0,1,1,1,3,4,3,2
142.0,1,2,1,2,4,4,3
142.0,1,3,2,6,9,5,1
142.0,1,3,2,7,10,6,2
142.0,1,4,2,6,10,7,3
142.0,1,0,0,2,2,8,1
142.0,1,0,0,2,2,9,2
142.0,1,0,0,2,2,10,3
142.0,1,0,0,2,2,11,4
142.0,1,-1,0,2,1,12,5
142.0,2,0,0,2,2,20,6
142.0,2,0,0,2,2,21,7
142.0,2,0,0,2,2,22,8
142.0,2,-1,2,8,7,23,1
142.0,2,-1,2,9,8,24,2
142.0,2,3,2,6,9,25,3
142.0,2,1,2,7,8,26,4
142.0,2,4,2,6,10,27,5
142.0,2,1,1,2,3,28,1
142.0,2,3,2,7,10,29,1
142.0,3,2,1,2,4,40,1
142.0,3,3,2,6,9,41,1
142.0,3,2,1,2,4,42,1
142.0,3,2,1,2,4,43,2
142.0,3,2,1,2,4,44,3
142.0,3,1,1,3,4,45,4
142.0,3,3,2,7,10,46,1
142.0,3,3,2,6,9,47,2
142.0,3,2,1,2,4,48,1
142.0,3,2,1,2,4,49,2
142.0,3,-5,2,6,1,50,1
142.0,4,0,0,2,2,60,1
142.0,4,0,0,2,2,61,2
142.0,4,0,0,2,2,62,3
142.0,4,0,2,8,8,63,1
142.0,4,0,2,7,7,64,2
142.0,4,0,2,6,6,65,3
142.0,4,2,2,6,8,66,4
142.0,4,2,2,6,8,67,5
142.0,4,3,2,6,9,68,6
142.0,4,1,0,2,3,69,1
142.0,4,0,0,2,2,70,2
142.0,5,0,1,3,3,80,1
142.0,5,1,1,2,3,81,2
142.0,5,1,1,2,3,82,3
142.0,5,2,1,2,4,83,4
142.0,5,2,1,2,4,84,5
142.0,5,2,1,2,4,85,6
142.0,5,2,1,2,4,86,7
142.0,5,2,1,2,4,87,8
142.0,5,2,1,2,4,88,9
142.0,5,2,1,2,4,89,10
142.0,5,2,1,2,4,90,11
142.0,5,1,1,3,4,91,12
142.0,5,1,1,3,4,92,13
143.0,1,-1,0,2,1,0,1
143.0,1,-1,0,2,1,1,2
143.0,1,-2,1,3,1,2,1
143.0,1,1,1,3,4,3,2
143.0,1,1,1,3,4,4,3
143.0,1,3,2,6,9,5,1
143.0,1,4,2,6,10,6,2
143.0,1,4,2,7,11,7,3
143.0,1,1,0,2,3,8,1
143.0,1,1,0,2,3,9,2
143.0,1,1,0,2,3,10,3
143.0,1,1,0,2,3,11,4
143.0,2,0,0,2,2,20,5
143.0,2,0,0,2,2,21,6
143.0,2,0,0,2,2,22,7
143.0,2,-1,2,8,7,23,1
143.0,2,0,2,8,8,24,2
143.0,2,2,2,7,9,25,3
143.0,2,2,2,7,9,26,4
143.0,2,3,2,6,9,27,5
143.0,2,2,1,2,4,28,1
143.0,2,3,2,6,9,29,1
143.0,3,2,1,2,4,40,1
143.0,3,2,2,7,9,41,1
143.0,3,2,1,2,4,42,1
143.0,3,2,1,2,4,43,2
143.0,3,2,1,3,5,44,3
143.0,3,2,1,2,4,45,4
143.0,3,3,2,7,10,46,1
143.0,3,3,2,6,9,47,2
143.0,3,2,1,2,4,48,1
143.0,3,1,1,3,4,49,2
143.0,4,1,0,2,3,60,1
143.0,4,1,0,2,3,61,2
143.0,4,1,0,2,3,62,3
143.0,4,4,2,5,9,63,1
143.0,4,3,2,6,9,64,2
143.0,4,3,2,7,10,65,3
143.0,4,2,2,5,7,66,4
143.0,4,3,2,7,10,67,5
143.0,4,3,2,6,9,68,6
143.0,5,1,1,3,4,80,1
143.0,5,2,1,3,5,81,2
143.0,5,1,1,3,4,82,3
143.0,5,1,1,3,4,83,4
143.0,5,1,1,3,4,84,5
143.0,5,2,1,2,4,85,6
143.0,5,1,1,3,4,86,7
143.0,5,2,1,2,4,87,8
143.0,5,2,1,2,4,88,9
143.0,5,2,1,2,4,89,10
143.0,5,2,1,2,4,90,11
143.0,5,2,1,2,4,91,12
146.0,1,1,0,2,3,0,1
146.0,1,1,0,2,3,1,2
146.0,1,1,1,3,4,2,1
146.0,1,1,1,3,4,3,2
146.0,1,1,1,3,4,4,3
146.0,1,3,2,7,10,5,1
146.0,1,3,2,6,9,6,2
146.0,1,3,2,6,9,7,3
146.0,1,2,0,2,4,8,1
146.0,1,1,0,2,3,9,2
146.0,1,1,0,2,3,10,3
146.0,2,0,0,2,2,20,4
146.0,2,0,0,2,2,21,5
146.0,2,0,0,2,2,22,6
146.0,2,3,2,8,11,23,1
146.0,2,2,2,8,10,24,2
146.0,2,3,2,6,9,25,3
146.0,2,3,2,5,8,26,4
146.0,2,2,2,6,8,27,5
146.0,2,2,1,2,4,28,1
146.0,2,-1,2,7,6,29,1
146.0,3,1,1,2,3,40,1
146.0,3,0,2,8,8,41,1
146.0,3,1,1,2,3,42,1
146.0,3,1,1,2,3,43,2
146.0,3,0,1,3,3,44,3
146.0,3,1,1,2,3,45,4
146.0,3,0,2,7,7,46,1
146.0,3,1,2,6,7,47,2
146.0,3,2,1,2,4,48,1
146.0,3,2,1,2,4,49,2
146.0,3,1,2,7,8,50,1
146.0,4,1,0,2,3,60,1
146.0,4,1,0,2,3,61,2
146.0,4,1,0,2,3,62,3
146.0,4,3,2,7,10,63,1
146.0,4,3,2,6,9,64,2
146.0,4,3,2,8,11,65,3
146.0,4,4,2,6,10,66,4
146.0,4,3,2,7,10,67,5
146.0,4,1,2,6,7,68,6
146.0,5,1,1,2,3,80,1
146.0,5,1,1,2,3,81,2
146.0,5,1,1,2,3,82,3
146.0,5,0,1,3,3,83,4
146.0,5,1,1,2,3,84,5
146.0,5,1,1,2,3,85,6
146.0,5,1,1,2,3,86,7
146.0,5,1,1,2,3,87,8
146.0,5,1,1,2,3,88,9
146.0,5,1,1,2,3,89,10
146.0,5,2,1,2,4,90,11
146.0,5,2,1,2,4,91,12
146.0,5,3,1,2,5,92,13
146.0,5,-1,1,2,1,93,14
148.0,1,-1,0,2,1,0,1
148.0,1,0,0,2,2,1,2
148.0,1,2,1,2,4,2,1
148.0,1,1,1,3,4,3,2
148.0,1,1,1,2,3,4,3
148.0,1,1,2,7,8,5,1
148.0,1,0,2,8,8,6,2
148.0,1,1,2,6,7,7,3
148.0,1,0,0,2,2,8,1
148.0,1,0,0,2,2,9,2
148.0,1,1,0,2,3,10,3
148.0,1,0,0,2,2,11,4
148.0,1,0,0,2,2,12,5
148.0,2,0,0,2,2,20,6
148.0,2,0,0,2,2,21,7
148.0,2,0,0,2,2,22,8
148.0,2,3,2,7,10,23,1
148.0,2,4,2,5,9,24,2
148.0,2,3,2,7,10,25,3
148.0,2,4,2,7,11,26,4
148.0,2,3,2,6,9,27,5
148.0,2,2,1,2,4,28,1
148.0,2,-4,2,7,3,29,1
148.0,3,1,1,2,3,40,1
148.0,3,0,2,6,6,41,1
148.0,3,1,1,2,3,42,1
148.0,3,0,1,3,3,43,2
148.0,3,1,1,2,3,44,3
148.0,3,1,1,2,3,45,4
148.0,3,3,2,6,9,46,1
148.0,3,4,2,5,9,47,2
148.0,3,2,1,2,4,48,1
148.0,3,1,1,3,4,49,2
148.0,3,3,2,6,9,50,1
148.0,4,1,0,2,3,60,1
148.0,4,1,0,2,3,61,2
148.0,4,0,0,2,2,62,3
148.0,4,3,2,6,9,63,1
148.0,4,3,2,8,11,64,2
148.0,4,3,2,6,9,65,3
148.0,4,3,2,5,8,66,4
148.0,4,3,2,6,9,67,5
148.0,4,4,2,7,11,68,6
148.0,5,2,1,2,4,80,1
148.0,5,2,1,2,4,81,2
148.0,5,2,1,2,4,82,3
148.0,5,2,1,2,4,83,4
148.0,5,2,1,3,5,84,5
148.0,5,2,1,2,4,85,6
148.0,5,2,1,2,4,86,7
148.0,5,2,1,2,4,87,8
148.0,5,2,1,2,4,88,9
148.0,5,2,1,2,4,89,10
148.0,5,2,1,2,4,90,11
148.0,5,1,1,3,4,91,12
151.0,1,-1,0,2,1,0,1
151.0,1,0,0,2,2,1,2
151.0,1,-1,1,2,1,2,1
151.0,1,2,1,3,5,3,2
151.0,1,3,1,2,5,4,3
151.0,1,3,2,7,10,5,1
151.0,1,3,2,8,11,6,2
151.0,1,5,2,5,10,7,3
151.0,1,0,0,2,2,8,1
151.0,1,0,0,2,2,9,2
151.0,1,0,0,2,2,10,3
151.0,1,0,0,2,2,11,4
151.0,2,1,0,2,3,20,5
151.0,2,1,0,2,3,21,6
151.0,2,0,0,2,2,22,7
151.0,2,3,2,7,10,23,1
151.0,2,3,2,7,10,24,2
151.0,2,3,2,6,9,25,3
151.0,2,4,2,9,13,26,4
151.0,2,2,2,6,8,27,5
151.0,2,2,1,2,4,28,1
151.0,3,2,1,2,4,40,2
151.0,3,3,2,6,9,41,1
151.0,3,2,1,2,4,42,1
151.0,3,2,1,2,4,43,2
151.0,3,2,1,2,4,44,3
151.0,3,2,1,2,4,45,4
151.0,3,3,2,7,10,46,1
151.0,3,4,2,8,12,47,2
151.0,3,1,1,3,4,48,1
151.0,3,2,1,2,4,49,2
151.0,4,1,0,2,3,60,1
151.0,4,1,0,2,3,61,2
151.0,4,0,0,2,2,62,3
151.0,4,2,2,7,9,63,1
151.0,4,3,2,7,10,64,2
151.0,4,2,2,6,8,65,3
151.0,4,0,2,7,7,66,4
151.0,4,3,2,6,9,67,5
151.0,4,1,2,7,8,68,6
151.0,4,0,0,2,2,69,1
151.0,5,1,1,2,3,80,1
151.0,5,1,1,2,3,81,2
151.0,5,2,1,2,4,82,3
151.0,5,1,1,2,3,83,4
151.0,5,1,1,3,4,84,5
151.0,5,0,1,3,3,85,6
151.0,5,1,1,2,3,86,7
151.0,5,0,1,3,3,87,8
151.0,5,1,1,2,3,88,9
151.0,5,0,1,3,3,89,10
151.0,5,0,1,2,2,90,11
151.0,5,2,1,2,4,91,12
151.0,5,2,1,2,4,92,13
151.0,5,-1,1,3,2,93,14
154.0,1,-1,0,2,1,0,1
154.0,1,0,0,2,2,1,2
154.0,1,2,1,3,5,2,1
154.0,1,1,1,3,4,3,2
154.0,1,1,1,3,4,4,3
154.0,1,3,2,8,11,5,1
154.0,1,4,2,6,10,6,2
154.0,1,4,2,6,10,7,3
154.0,1,0,0,2,2,8,1
154.0,1,1,0,2,3,9,2
154.0,1,0,0,2,2,10,3
154.0,2,1,0,2,3,20,4
154.0,2,1,0,2,3,21,5
154.0,2,0,0,2,2,22,6
154.0,2,3,2,6,9,23,1
154.0,2,3,2,6,9,24,2
154.0,2,3,2,6,9,25,3
154.0,2,3,2,7,10,26,4
154.0,2,3,2,8,11,27,5
154.0,2,1,1,2,3,28,1
154.0,2,-3,2,6,3,29,1
154.0,3,0,1,3,3,40,1
154.0,3,0,2,6,6,41,1
154.0,3,1,1,2,3,42,1
154.0,3,1,1,2,3,43,2
154.0,3,1,1,2,3,44,3
154.0,3,1,1,2,3,45,4
154.0,3,0,2,7,7,46,1
154.0,3,0,2,6,6,47,2
154.0,3,1,1,3,4,48,1
154.0,3,2,1,2,4,49,2
154.0,3,4,2,6,10,50,1
154.0,3,-4,2,5,1,51,2
154.0,4,0,0,2,2,60,1
154.0,4,0,0,2,2,61,2
154.0,4,0,0,2,2,62,3
154.0,4,0,2,6,6,63,1
154.0,4,0,2,6,6,64,2
154.0,4,3,2,6,9,65,3
154.0,4,2,2,7,9,66,4
154.0,4,3,2,7,10,67,5
154.0,4,3,2,6,9,68,6
154.0,4,0,0,2,2,69,1
154.0,5,1,1,2,3,80,1
154.0,5,1,1,2,3,81,2
154.0,5,1,1,2,3,82,3
154.0,5,2,1,2,4,83,4
154.0,5,2,1,2,4,84,5
154.0,5,2,1,2,4,85,6
154.0,5,2,1,2,4,86,7
154.0,5,2,1,2,4,87,8
154.0,5,3,1,2,5,88,9
154.0,5,2,1,2,4,89,10
154.0,5,2,1,2,4,90,11
154.0,5,1,1,3,4,91,12
154.0,5,1,1,2,3,92,13
158.0,1,1,0,2,3,0,1
158.0,1,-1,0,2,1,1,2
158.0,1,2,1,3,5,2,1
158.0,1,1,1,3,4,3,2
158.0,1,1,1,3,4,4,3
158.0,1,4,2,6,10,5,1
158.0,1,2,2,7,9,6,2
158.0,1,3,2,6,9,7,3
158.0,1,1,0,2,3,8,1
158.0,1,1,0,2,3,9,2
158.0,1,0,0,2,2,10,3
158.0,2,0,0,2,2,20,4
158.0,2,0,0,2,2,21,5
158.0,2,0,0,2,2,22,6
158.0,2,-1,2,7,6,23,1
158.0,2,0,2,7,7,24,2
158.0,2,3,2,6,9,25,3
158.0,2,4,2,7,11,26,4
158.0,2,4,2,7,11,27,5
158.0,2,1,1,3,4,28,1
158.0,2,3,2,5,8,29,1
158.0,3,1,1,2,3,40,1
158.0,3,0,2,7,7,41,1
158.0,3,0,1,3,3,42,1
158.0,3,1,1,2,3,43,2
158.0,3,1,1,2,3,44,3
158.0,3,1,1,2,3,45,4
158.0,3,0,2,8,8,46,1
158.0,3,3,2,5,8,47,2
158.0,3,1,1,2,3,48,1
158.0,3,1,1,3,4,49,2
158.0,3,4,2,6,10,50,1
158.0,4,0,0,2,2,60,1
158.0,4,0,0,2,2,61,2
158.0,4,0,0,2,2,62,3
158.0,4,4,2,6,10,63,1
158.0,4,5,2,6,11,64,2
158.0,4,4,2,6,10,65,3
158.0,4,2,2,7,9,66,4
158.0,4,4,2,6,10,67,5
158.0,4,3,2,7,10,68,6
158.0,5,1,1,2,3,80,1
158.0,5,1,1,2,3,81,2
158.0,5,1,1,2,3,82,3
158.0,5,1,1,2,3,83,4
158.0,5,1,1,2,3,84,5
158.0,5,1,1,2,3,85,6
158.0,5,1,1,2,3,86,7
158.0,5,1,1,2,3,87,8
158.0,5,2,1,2,4,88,9
158.0,5,2,1,2,4,89,10
158.0,5,1,1,3,4,90,11
158.0,5,2,1,2,4,91,12
158.0,5,2,1,2,4,92,13
159.0,1,-1,0,2,1,0,1
159.0,1,-1,0,2,1,1,2
159.0,1,1,1,3,4,2,1
159.0,1,-2,1,3,1,3,2
159.0,1,-2,1,3,1,4,3
159.0,1,3,2,6,9,5,1
159.0,1,3,2,6,9,6,2
159.0,1,3,2,6,9,7,3
159.0,1,1,0,2,3,8,1
159.0,1,1,0,2,3,9,2
159.0,1,0,0,2,2,10,3
159.0,1,0,0,2,2,11,4
159.0,1,0,0,2,2,12,5
159.0,2,0,0,2,2,20,6
159.0,2,0,0,2,2,21,7
159.0,2,1,0,2,3,22,8
159.0,2,2,2,7,9,23,1
159.0,2,3,2,6,9,24,2
159.0,2,3,2,5,8,25,3
159.0,2,2,2,7,9,26,4
159.0,2,3,2,6,9,27,5
159.0,2,2,1,2,4,28,1
159.0,2,-1,2,8,7,29,1
159.0,3,1,1,2,3,40,1
159.0,3,0,2,6,6,41,1
159.0,3,1,1,2,3,42,1
159.0,3,1,1,2,3,43,2
159.0,3,0,1,3,3,44,3
159.0,3,1,1,2,3,45,4
159.0,3,3,2,6,9,46,1
159.0,3,5,2,6,11,47,2
159.0,3,2,1,2,4,48,1
159.0,3,2,1,2,4,49,2
159.0,3,2,2,6,8,50,1
159.0,4,1,0,2,3,60,1
159.0,4,0,0,2,2,61,2
159.0,4,1,0,2,3,62,3
159.0,4,3,2,7,10,63,1
159.0,4,4,2,6,10,64,2
159.0,4,4,2,6,10,65,3
159.0,4,4,2,8,12,66,4
159.0,4,3,2,7,10,67,5
159.0,4,0,2,6,6,68,6
159.0,5,1,1,2,3,80,1
159.0,5,1,1,2,3,81,2
159.0,5,1,1,2,3,82,3
159.0,5,0,1,3,3,83,4
159.0,5,0,1,3,3,84,5
159.0,5,1,1,2,3,85,6
159.0,5,1,1,2,3,86,7
159.0,5,1,1,2,3,87,8
159.0,5,1,1,3,4,88,9
159.0,5,1,1,3,4,89,10
159.0,5,1,1,3,4,90,11
159.0,5,2,1,2,4,91,12
159.0,5,1,1,3,4,92,13
161.0,1,1,0,2,3,0,1
161.0,1,-1,0,2,1,1,2
161.0,1,-2,1,3,1,2,1
161.0,1,-2,1,3,1,3,2
161.0,1,-2,1,3,1,4,3
161.0,1,3,2,6,9,5,1
161.0,1,3,2,7,10,6,2
161.0,1,3,2,6,9,7,3
161.0,1,0,0,2,2,8,1
161.0,1,1,0,2,3,9,2
161.0,1,1,0,2,3,10,3
161.0,1,0,0,2,2,11,4
161.0,1,1,0,2,3,12,5
161.0,2,1,0,2,3,20,6
161.0,2,0,0,2,2,21,7
161.0,2,1,0,2,3,22,8
161.0,2,2,2,6,8,23,1
161.0,2,3,2,6,9,24,2
161.0,2,3,2,7,10,25,3
161.0,2,3,2,7,10,26,4
161.0,2,3,2,7,10,27,5
161.0,2,1,1,3,4,28,1
161.0,2,-4,2,7,3,29,1
161.0,3,1,1,2,3,40,1
161.0,3,0,2,6,6,41,1
161.0,3,1,1,2,3,42,1
161.0,3,0,1,3,3,43,2
161.0,3,1,1,2,3,44,3
161.0,3,0,1,3,3,45,4
161.0,3,3,2,6,9,46,1
161.0,3,3,2,7,10,47,2
161.0,3,1,1,3,4,48,1
161.0,3,2,1,2,4,49,2
161.0,3,2,2,7,9,50,1
161.0,4,1,0,2,3,60,1
161.0,4,0,0,2,2,61,2
161.0,4,0,0,2,2,62,3
161.0,4,0,2,5,5,63,1
161.0,4,0,2,6,6,64,2
161.0,4,0,2,7,7,65,3
161.0,4,1,2,6,7,66,4
161.0,4,3,2,7,10,67,5
161.0,4,1,2,7,8,68,6
161.0,4,0,0,2,2,69,1
161.0,4,0,0,2,2,70,2
161.0,5,1,1,2,3,80,1
161.0,5,2,1,3,5,81,2
161.0,5,2,1,2,4,82,3
161.0,5,1,1,3,4,83,4
161.0,5,1,1,3,4,84,5
161.0,5,2,1,2,4,85,6
161.0,5,2,1,2,4,86,7
161.0,5,2,1,2,4,87,8
161.0,5,2,1,2,4,88,9
161.0,5,2,1,2,4,89,10
161.0,5,2,1,2,4,90,11
161.0,5,1,1,3,4,91,12
161.0,5,-1,1,2,1,92,13
162.0,1,1,0,2,3,0,1
162.0,1,0,0,2,2,1,2
162.0,1,1,1,3,4,2,1
162.0,1,1,1,3,4,3,2
162.0,1,1,1,3,4,4,3
162.0,1,3,2,6,9,5,1
162.0,1,3,2,7,10,6,2
162.0,1,4,2,6,10,7,3
162.0,1,1,0,2,3,8,1
162.0,1,1,0,2,3,9,2
162.0,1,0,0,2,2,10,3
162.0,2,1,0,2,3,20,4
162.0,2,0,0,2,2,21,5
162.0,2,0,0,2,2,22,6
162.0,2,0,2,8,8,23,1
162.0,2,0,2,7,7,24,2
162.0,2,4,2,6,10,25,3
162.0,2,3,2,7,10,26,4
162.0,2,3,2,6,9,27,5
162.0,2,2,1,2,4,28,1
162.0,2,0,2,7,7,29,1
162.0,3,1,1,2,3,40,1
162.0,3,0,2,6,6,41,1
162.0,3,1,1,2,3,42,1
162.0,3,0,1,3,3,43,2
162.0,3,1,1,2,3,44,3
162.0,3,1,1,2,3,45,4
162.0,3,2,2,6,8,46,1
162.0,3,4,2,7,11,47,2
162.0,3,2,1,2,4,48,1
162.0,3,2,1,2,4,49,2
162.0,3,2,2,7,9,50,1
162.0,4,0,0,2,2,60,1
162.0,4,0,0,2,2,61,2
162.0,4,0,0,2,2,62,3
162.0,4,0,2,6,6,63,1
162.0,4,0,2,8,8,64,2
162.0,4,0,2,7,7,65,3
162.0,4,0,2,7,7,66,4
162.0,4,0,2,7,7,67,5
162.0,4,2,2,6,8,68,6
162.0,4,0,0,2,2,69,1
162.0,4,1,0,2,3,70,2
162.0,5,2,1,2,4,80,1
162.0,5,1,1,3,4,81,2
162.0,5,2,1,2,4,82,3
162.0,5,2,1,2,4,83,4
162.0,5,2,1,2,4,84,5
162.0,5,2,1,2,4,85,6
162.0,5,2,1,2,4,86,7
162.0,5,2,1,2,4,87,8
162.0,5,2,1,3,5,88,9
162.0,5,2,1,2,4,89,10
162.0,5,2,1,2,4,90,11
162.0,5,2,1,2,4,91,12
163.0,1,-1,0,2,1,0,1
163.0,1,-1,0,2,1,1,2
163.0,1,-2,1,3,1,2,1
163.0,1,1,1,3,4,3,2
163.0,1,1,1,3,4,4,3
163.0,1,4,2,7,11,5,1
163.0,1,2,2,6,8,6,2
163.0,1,4,2,7,11,7,3
163.0,1,1,0,2,3,8,1
163.0,1,1,0,2,3,9,2
163.0,1,1,0,2,3,10,3
163.0,1,1,0,2,3,11,4
163.0,2,1,0,2,3,20,5
163.0,2,0,0,2,2,21,6
163.0,2,0,0,2,2,22,7
163.0,2,3,2,6,9,23,1
163.0,2,4,2,6,10,24,2
163.0,2,3,2,7,10,25,3
163.0,2,2,2,7,9,26,4
163.0,2,3,2,6,9,27,5
163.0,2,0,1,3,3,28,1
163.0,2,-2,2,7,5,29,1
163.0,3,1,1,2,3,40,1
163.0,3,1,2,7,8,41,1
163.0,3,1,1,2,3,42,1
163.0,3,1,1,2,3,43,2
163.0,3,1,1,2,3,44,3
163.0,3,0,1,3,3,45,4
163.0,3,1,2,7,8,46,1
163.0,3,2,2,6,8,47,2
163.0,3,2,1,2,4,48,1
163.0,3,2,1,2,4,49,2
163.0,3,2,2,7,9,50,1
163.0,4,1,0,2,3,60,1
163.0,4,1,0,2,3,61,2
163.0,4,1,0,2,3,62,3
163.0,4,4,2,6,10,63,1
163.0,4,3,2,7,10,64,2
163.0,4,4,2,6,10,65,3
163.0,4,3,2,6,9,66,4
163.0,4,3,2,5,8,67,5
163.0,4,2,2,7,9,68,6
163.0,5,2,1,2,4,80,1
163.0,5,2,1,2,4,81,2
163.0,5,2,1,2,4,82,3
163.0,5,2,1,2,4,83,4
163.0,5,2,1,2,4,84,5
163.0,5,1,1,3,4,85,6
163.0,5,2,1,2,4,86,7
163.0,5,2,1,2,4,87,8
163.0,5,2,1,3,5,88,9
163.0,5,2,1,2,4,89,10
163.0,5,2,1,2,4,90,11
163.0,5,2,1,2,4,91,12
164.0,1,-1,0,2,1,0,1
164.0,1,0,0,2,2,1,2
164.0,1,-2,1,3,1,2,1
164.0,1,-2,1,3,1,3,2
164.0,1,-2,1,3,1,4,3
164.0,1,-6,2,7,1,5,1
164.0,1,-7,2,8,1,6,2
164.0,1,2,2,6,8,7,3
164.0,1,0,0,2,2,8,1
164.0,1,1,0,2,3,9,2
164.0,1,1,0,2,3,10,3
164.0,1,1,0,2,3,11,4
164.0,1,0,0,2,2,12,5
164.0,1,3,2,7,10,13,1
164.0,1,-7,2,8,1,14,2
164.0,2,0,0,2,2,20,1
164.0,2,1,0,2,3,21,2
164.0,2,0,0,2,2,22,3
164.0,2,3,2,7,10,23,1
164.0,2,3,2,6,9,24,2
164.0,2,2,2,8,10,25,3
164.0,2,2,2,7,9,26,4
164.0,2,3,2,7,10,27,5
164.0,2,2,1,2,4,28,1
164.0,2,-4,2,7,3,29,1
164.0,3,0,1,3,3,40,1
164.0,3,0,2,7,7,41,1
164.0,3,1,1,2,3,42,1
164.0,3,1,1,2,3,43,2
164.0,3,1,1,2,3,44,3
164.0,3,1,1,2,3,45,4
164.0,3,3,2,6,9,46,1
164.0,3,4,2,7,11,47,2
164.0,3,1,1,3,4,48,1
164.0,3,1,1,3,4,49,2
164.0,3,0,2,7,7,50,1
164.0,4,0,0,2,2,60,1
164.0,4,0,0,2,2,61,2
164.0,4,0,0,2,2,62,3
164.0,4,0,2,6,6,63,1
164.0,4,-1,2,8,7,64,2
164.0,4,0,2,6,6,65,3
164.0,4,3,2,6,9,66,4
164.0,4,4,2,6,10,67,5
164.0,4,3,2,6,9,68,6
164.0,4,1,0,2,3,69,1
164.0,4,-1,0,2,1,70,2
164.0,5,1,1,2,3,80,1
164.0,5,1,1,2,3,81,2
164.0,5,1,1,2,3,82,3
164.0,5,1,1,3,4,83,4
164.0,5,0,1,3,3,84,5
164.0,5,1,1,2,3,85,6
164.0,5,1,1,2,3,86,7
164.0,5,1,1,2,3,87,8
164.0,5,1,1,3,4,88,9
164.0,5,0,1,3,3,89,10
164.0,5,2,1,2,4,90,11
164.0,5,2,1,2,4,91,12
164.0,5,2,1,2,4,92,13
165.0,1,0,0,2,2,0,1
165.0,1,1,0,2,3,1,2
165.0,1,2,1,3,5,2,1
165.0,1,1,1,3,4,3,2
165.0,1,1,1,3,4,4,3
165.0,1,3,2,6,9,5,1
165.0,1,3,2,7,10,6,2
165.0,1,4,2,7,11,7,3
165.0,1,1,0,2,3,8,1
165.0,1,1,0,2,3,9,2
165.0,1,1,0,2,3,10,3
165.0,2,1,0,2,3,20,4
165.0,2,1,0,2,3,21,5
165.0,2,0,0,2,2,22,6
165.0,2,0,2,7,7,23,1
165.0,2,3,2,6,9,24,2
165.0,2,3,2,8,11,25,3
165.0,2,3,2,5,8,26,4
165.0,2,3,2,7,10,27,5
165.0,2,2,1,2,4,28,1
165.0,2,-3,2,8,5,29,1
165.0,3,0,1,3,3,40,1
165.0,3,1,2,6,7,41,1
165.0,3,1,1,2,3,42,1
165.0,3,1,1,2,3,43,2
165.0,3,1,1,2,3,44,3
165.0,3,1,1,2,3,45,4
165.0,3,0,2,7,7,46,1
165.0,3,2,2,7,9,47,2
165.0,3,1,1,3,4,48,1
165.0,3,1,1,2,3,49,2
165.0,3,3,2,6,9,50,1
165.0,4,1,0,2,3,60,1
165.0,4,1,0,2,3,61,2
165.0,4,0,0,2,2,62,3
165.0,4,3,2,7,10,63,1
165.0,4,4,2,7,11,64,2
165.0,4,5,2,6,11,65,3
165.0,4,3,2,5,8,66,4
165.0,4,3,2,6,9,67,5
165.0,4,3,2,6,9,68,6
165.0,5,0,1,3,3,80,1
165.0,5,0,1,3,3,81,2
165.0,5,1,1,2,3,82,3
165.0,5,1,1,2,3,83,4
165.0,5,1,1,2,3,84,5
165.0,5,1,1,2,3,85,6
165.0,5,1,1,2,3,86,7
165.0,5,1,1,2,3,87,8
165.0,5,1,1,2,3,88,9
165.0,5,2,1,2,4,89,10
165.0,5,2,1,2,4,90,11
165.0,5,2,1,2,4,91,12
165.0,5,2,1,2,4,92,13
165.0,5,-1,1,2,1,93,14
167.0,1,0,0,2,2,0,1
167.0,1,1,0,2,3,1,2
167.0,1,1,1,3,4,2,1
167.0,1,1,1,3,4,3,2
167.0,1,1,1,3,4,4,3
167.0,1,3,2,5,8,5,1
167.0,1,3,2,6,9,6,2
167.0,1,3,2,7,10,7,3
167.0,1,0,0,2,2,8,1
167.0,1,0,0,2,2,9,2
167.0,1,0,0,2,2,10,3
167.0,1,1,0,2,3,11,4
167.0,2,0,0,2,2,20,5
167.0,2,2,0,2,4,21,6
167.0,2,1,0,2,3,22,7
167.0,2,1,2,8,9,23,1
167.0,2,3,2,7,10,24,2
167.0,2,3,2,6,9,25,3
167.0,2,3,2,7,10,26,4
167.0,2,3,2,6,9,27,5
167.0,2,1,1,3,4,28,1
167.0,2,-5,2,7,2,29,1
167.0,3,1,1,2,3,40,1
167.0,3,0,2,7,7,41,1
167.0,3,1,1,2,3,42,1
167.0,3,0,1,3,3,43,2
167.0,3,0,1,3,3,44,3
167.0,3,1,1,2,3,45,4
167.0,3,0,2,7,7,46,1
167.0,3,2,2,7,9,47,2
167.0,3,2,1,2,4,48,1
167.0,3,2,1,2,4,49,2
167.0,3,5,2,6,11,50,1
167.0,4,1,0,2,3,60,1
167.0,4,1,0,2,3,61,2
167.0,4,0,0,2,2,62,3
167.0,4,3,2,7,10,63,1
167.0,4,3,2,6,9,64,2
167.0,4,2,2,6,8,65,3
167.0,4,2,2,6,8,66,4
167.0,4,3,2,6,9,67,5
167.0,4,4,2,7,11,68,6
167.0,5,2,1,2,4,80,1
167.0,5,2,1,2,4,81,2
167.0,5,2,1,2,4,82,3
167.0,5,2,1,2,4,83,4
167.0,5,2,1,2,4,84,5
167.0,5,1,1,3,4,85,6
167.0,5,2,1,2,4,86,7
167.0,5,1,1,3,4,87,8
167.0,5,2,1,2,4,88,9
167.0,5,2,1,2,4,89,10
167.0,5,2,1,2,4,90,11
167.0,5,2,1,2,4,91,12
167.0,5,-1,1,2,1,92,13
168.0,1,1,0,2,3,0,1
168.0,1,0,0,2,2,1,2
168.0,1,0,1,3,3,2,1
168.0,1,1,1,2,3,3,2
168.0,1,1,1,3,4,4,3
168.0,1,4,2,8,12,5,1
168.0,1,4,2,7,11,6,2
168.0,1,4,2,7,11,7,3
168.0,1,1,0,2,3,8,1
168.0,1,1,0,2,3,9,2
168.0,1,0,0,2,2,10,3
168.0,2,0,0,2,2,20,4
168.0,2,0,0,2,2,21,5
168.0,2,0,0,2,2,22,6
168.0,2,0,2,6,6,23,1
168.0,2,0,2,6,6,24,2
168.0,2,3,2,6,9,25,3
168.0,2,4,2,6,10,26,4
168.0,2,2,2,7,9,27,5
168.0,2,1,1,2,3,28,1
168.0,2,0,2,6,6,29,1
168.0,2,-5,2,7,2,30,2
168.0,3,1,1,2,3,40,1
168.0,3,0,2,6,6,41,1
168.0,3,1,1,2,3,42,1
168.0,3,1,1,2,3,43,2
168.0,3,1,1,2,3,44,3
168.0,3,1,1,2,3,45,4
168.0,3,0,2,6,6,46,1
168.0,3,3,2,7,10,47,2
168.0,3,2,1,2,4,48,1
168.0,3,2,1,2,4,49,2
168.0,3,3,2,7,10,50,1
168.0,4,1,0,2,3,60,1
168.0,4,1,0,2,3,61,2
168.0,4,1,0,2,3,62,3
168.0,4,3,2,6,9,63,1
168.0,4,2,2,7,9,64,2
168.0,4,4,2,6,10,65,3
168.0,4,3,2,8,11,66,4
168.0,4,3,2,5,8,67,5
168.0,4,4,2,6,10,68,6
168.0,5,2,1,2,4,80,1
168.0,5,2,1,2,4,81,2
168.0,5,3,1,2,5,82,3
168.0,5,2,1,2,4,83,4
168.0,5,2,1,2,4,84,5
168.0,5,2,1,2,4,85,6
168.0,5,2,1,2,4,86,7
168.0,5,2,1,2,4,87,8
168.0,5,2,1,2,4,88,9
168.0,5,2,1,2,4,89,10
168.0,5,2,1,2,4,90,11
168.0,5,1,1,3,4,91,12
169.0,1,1,0,2,3,0,1
169.0,1,0,0,2,2,1,2
169.0,1,1,1,3,4,2,1
169.0,1,1,1,3,4,3,2
169.0,1,1,1,3,4,4,3
169.0,1,3,2,7,10,5,1
169.0,1,4,2,6,10,6,2
169.0,1,3,2,5,8,7,3
169.0,1,0,0,2,2,8,1
169.0,1,1,0,2,3,9,2
169.0,1,4,0,2,6,10,3
169.0,2,1,0,2,3,20,4
169.0,2,1,0,2,3,21,5
169.0,2,1,0,2,3,22,6
169.0,2,2,2,8,10,23,1
169.0,2,3,2,7,10,24,2
169.0,2,3,2,7,10,25,3
169.0,2,3,2,7,10,26,4
169.0,2,3,2,5,8,27,5
169.0,2,2,1,2,4,28,1
169.0,2,-4,2,5,1,29,1
169.0,3,1,1,2,3,40,1
169.0,3,0,2,6,6,41,1
169.0,3,0,1,3,3,42,1
169.0,3,0,1,3,3,43,2
169.0,3,0,1,3,3,44,3
169.0,3,2,1,2,4,45,4
169.0,3,3,2,7,10,46,1
169.0,3,3,2,6,9,47,2
169.0,3,2,1,2,4,48,1
169.0,3,1,1,3,4,49,2
169.0,3,1,2,7,8,50,1
169.0,4,0,0,2,2,60,1
169.0,4,0,0,2,2,61,2
169.0,4,0,0,2,2,62,3
169.0,4,-1,2,8,7,63,1
169.0,4,0,2,7,7,64,2
169.0,4,2,2,6,8,65,3
169.0,4,2,2,7,9,66,4
169.0,4,4,2,6,10,67,5
169.0,4,2,2,6,8,68,6
169.0,4,0,0,2,2,69,1
169.0,5,2,1,2,4,80,1
169.0,5,1,1,3,4,81,2
169.0,5,2,1,2,4,82,3
169.0,5,1,1,3,4,83,4
169.0,5,2,1,2,4,84,5
169.0,5,1,1,3,4,85,6
169.0,5,2,1,2,4,86,7
169.0,5,1,1,3,4,87,8
169.0,5,1,1,3,4,88,9
169.0,5,2,1,2,4,89,10
169.0,5,1,1,3,4,90,11
169.0,5,2,1,2,4,91,12
169.0,5,-1,1,2,1,92,13
170.0,1,1,0,2,3,0,1
170.0,1,-1,0,2,1,1,2
170.0,1,1,1,3,4,2,1
170.0,1,1,1,3,4,3,2
170.0,1,1,1,3,4,4,3
170.0,1,3,2,7,10,5,1
170.0,1,2,2,7,9,6,2
170.0,1,3,2,7,10,7,3
170.0,1,2,0,2,4,8,1
170.0,1,1,0,2,3,9,2
170.0,1,1,0,2,3,10,3
170.0,2,1,0,2,3,20,4
170.0,2,1,0,2,3,21,5
170.0,2,0,0,2,2,22,6
170.0,2,3,2,6,9,23,1
170.0,2,3,2,8,11,24,2
170.0,2,3,2,7,10,25,3
170.0,2,4,2,7,11,26,4
170.0,2,3,2,8,11,27,5
170.0,2,2,1,2,4,28,1
170.0,3,2,1,2,4,40,2
170.0,3,2,2,7,9,41,1
170.0,3,2,1,2,4,42,1
170.0,3,2,1,2,4,43,2
170.0,3,2,1,3,5,44,3
170.0,3,2,1,2,4,45,4
170.0,3,3,2,6,9,46,1
170.0,3,3,2,7,10,47,2
170.0,3,2,1,2,4,48,1
170.0,3,1,1,3,4,49,2
170.0,4,1,0,2,3,60,1
170.0,4,1,0,2,3,61,2
170.0,4,1,0,2,3,62,3
170.0,4,3,2,7,10,63,1
170.0,4,3,2,7,10,64,2
170.0,4,2,2,8,10,65,3
170.0,4,4,2,5,9,66,4
170.0,4,3,2,7,10,67,5
170.0,4,2,2,6,8,68,6
170.0,5,2,1,2,4,80,1
170.0,5,2,1,2,4,81,2
170.0,5,2,1,2,4,82,3
170.0,5,2,1,2,4,83,4
170.0,5,2,1,2,4,84,5
170.0,5,2,1,2,4,85,6
170.0,5,1,1,3,4,86,7
170.0,5,2,1,2,4,87,8
170.0,5,2,1,2,4,88,9
170.0,5,2,1,2,4,89,10
170.0,5,1,1,3,4,90,11
170.0,5,2,1,2,4,91,12
170.0,5,-2,1,3,1,92,13
173.0,1,1,0,2,3,0,1
173.0,1,1,0,2,3,1,2
173.0,1,2,1,3,5,2,1
173.0,1,1,1,3,4,3,2
173.0,1,1,1,3,4,4,3
173.0,1,3,2,8,11,5,1
173.0,1,3,2,7,10,6,2
173.0,1,4,2,6,10,7,3
173.0,1,1,0,2,3,8,1
173.0,1,1,0,2,3,9,2
173.0,1,-1,0,2,1,10,3
173.0,2,0,0,2,2,20,4
173.0,2,0,0,2,2,21,5
173.0,2,0,0,2,2,22,6
173.0,2,3,2,6,9,23,1
173.0,2,3,2,8,11,24,2
173.0,2,2,2,7,9,25,3
173.0,2,4,2,9,13,26,4
173.0,2,4,2,7,11,27,5
173.0,2,2,1,2,4,28,1
173.0,3,2,1,2,4,40,2
173.0,3,4,2,7,11,41,1
173.0,3,1,1,3,4,42,1
173.0,3,2,1,2,4,43,2
173.0,3,2,1,2,4,44,3
173.0,3,1,1,3,4,45,4
173.0,3,3,2,6,9,46,1
173.0,3,3,2,8,11,47,2
173.0,3,2,1,2,4,48,1
173.0,3,2,1,2,4,49,2
173.0,4,1,0,2,3,60,1
173.0,4,1,0,2,3,61,2
173.0,4,1,0,2,3,62,3
173.0,4,3,2,6,9,63,1
173.0,4,4,2,7,11,64,2
173.0,4,2,2,7,9,65,3
173.0,4,2,2,7,9,66,4
173.0,4,0,2,6,6,67,5
173.0,4,4,2,5,9,68,6
173.0,5,2,1,2,4,80,1
173.0,5,2,1,2,4,81,2
173.0,5,1,1,3,4,82,3
173.0,5,2,1,2,4,83,4
173.0,5,1,1,3,4,84,5
173.0,5,2,1,3,5,85,6
173.0,5,2,1,2,4,86,7
173.0,5,1,1,3,4,87,8
173.0,5,2,1,2,4,88,9
173.0,5,2,1,2,4,89,10
173.0,5,2,1,2,4,90,11
173.0,5,2,1,2,4,91,12
175.0,1,1,0,2,3,0,1
175.0,1,1,0,2,3,1,2
175.0,1,-2,1,3,1,2,1
175.0,1,-2,1,3,1,3,2
175.0,1,-2,1,3,1,4,3
175.0,1,2,2,7,9,5,1
175.0,1,3,2,7,10,6,2
175.0,1,5,2,7,12,7,3
175.0,1,1,0,2,3,8,1
175.0,1,1,0,2,3,9,2
175.0,1,1,0,2,3,10,3
175.0,1,0,0,2,2,11,4
175.0,2,1,0,2,3,20,5
175.0,2,0,0,2,2,21,6
175.0,2,0,0,2,2,22,7
175.0,2,3,2,8,11,23,1
175.0,2,4,2,5,9,24,2
175.0,2,3,2,7,10,25,3
175.0,2,2,2,7,9,26,4
175.0,2,4,2,6,10,27,5
175.0,2,2,1,2,4,28,1
175.0,2,-4,2,6,2,29,1
175.0,3,1,1,2,3,40,1
175.0,3,0,2,7,7,41,1
175.0,3,1,1,2,3,42,1
175.0,3,1,1,2,3,43,2
175.0,3,1,1,2,3,44,3
175.0,3,0,1,3,3,45,4
175.0,3,0,2,6,6,46,1
175.0,3,3,2,8,11,47,2
175.0,3,1,1,3,4,48,1
175.0,3,2,1,2,4,49,2
175.0,3,3,2,7,10,50,1
175.0,4,0,0,2,2,60,1
175.0,4,0,0,2,2,61,2
175.0,4,0,0,2,2,62,3
175.0,4,0,2,7,7,63,1
175.0,4,0,2,6,6,64,2
175.0,4,0,2,6,6,65,3
175.0,4,0,2,7,7,66,4
175.0,4,2,2,7,9,67,5
175.0,4,3,2,6,9,68,6
175.0,4,0,0,2,2,69,1
175.0,4,0,0,2,2,70,2
175.0,5,2,1,2,4,80,1
175.0,5,1,1,3,4,81,2
175.0,5,2,1,2,4,82,3
175.0,5,2,1,2,4,83,4
175.0,5,2,1,2,4,84,5
175.0,5,2,1,2,4,85,6
175.0,5,2,1,2,4,86,7
175.0,5,2,1,2,4,87,8
175.0,5,1,1,3,4,88,9
175.0,5,2,1,2,4,89,10
175.0,5,2,1,2,4,90,11
175.0,5,1,1,3,4,91,12
175.0,5,-1,1,2,1,92,13
177.0,1,1,0,2,3,0,1
177.0,1,0,0,2,2,1,2
177.0,1,-2,1,3,1,2,1
177.0,1,1,1,3,4,3,2
177.0,1,1,1,3,4,4,3
177.0,1,3,2,6,9,5,1
177.0,1,3,2,7,10,6,2
177.0,1,4,2,6,10,7,3
177.0,1,1,0,2,3,8,1
177.0,1,0,0,2,2,9,2
177.0,1,0,0,2,2,10,3
177.0,1,1,0,2,3,11,4
177.0,2,1,0,2,3,20,5
177.0,2,0,0,2,2,21,6
177.0,2,0,0,2,2,22,7
177.0,2,0,2,7,7,23,1
177.0,2,0,2,8,8,24,2
177.0,2,2,2,6,8,25,3
177.0,2,1,2,7,8,26,4
177.0,2,3,2,6,9,27,5
177.0,2,2,1,2,4,28,1
177.0,2,4,2,7,11,29,1
177.0,3,1,1,2,3,40,1
177.0,3,0,2,6,6,41,1
177.0,3,1,1,2,3,42,1
177.0,3,1,1,2,3,43,2
177.0,3,1,1,2,3,44,3
177.0,3,1,1,2,3,45,4
177.0,3,0,2,6,6,46,1
177.0,3,0,2,6,6,47,2
177.0,3,1,1,2,3,48,1
177.0,3,1,1,2,3,49,2
177.0,3,0,2,7,7,50,1
177.0,3,1,2,6,7,51,2
177.0,4,0,0,2,2,60,1
177.0,4,0,0,2,2,61,2
177.0,4,0,0,2,2,62,3
177.0,4,0,2,8,8,63,1
177.0,4,0,2,6,6,64,2
177.0,4,1,2,6,7,65,3
177.0,4,1,2,6,7,66,4
177.0,4,1,2,6,7,67,5
177.0,4,4,2,6,10,68,6
177.0,4,0,0,2,2,69,1
177.0,4,0,0,2,2,70,2
177.0,5,1,1,2,3,80,1
177.0,5,1,1,2,3,81,2
177.0,5,1,1,2,3,82,3
177.0,5,1,1,2,3,83,4
177.0,5,2,1,2,4,84,5
177.0,5,2,1,2,4,85,6
177.0,5,2,1,2,4,86,7
177.0,5,2,1,2,4,87,8
177.0,5,2,1,2,4,88,9
177.0,5,2,1,2,4,89,10
177.0,5,1,1,3,4,90,11
177.0,5,2,1,2,4,91,12
177.0,5,1,1,3,4,92,13
182.0,1,1,0,2,3,0,1
182.0,1,0,0,2,2,1,2
182.0,1,1,1,3,4,2,1
182.0,1,1,1,3,4,3,2
182.0,1,2,1,2,4,4,3
182.0,1,2,2,6,8,5,1
182.0,1,3,2,7,10,6,2
182.0,1,4,2,5,9,7,3
182.0,1,0,0,2,2,8,1
182.0,1,0,0,2,2,9,2
182.0,1,1,0,2,3,10,3
182.0,1,0,0,2,2,11,4
182.0,2,1,0,2,3,20,5
182.0,2,0,0,2,2,21,6
182.0,2,1,0,2,3,22,7
182.0,2,2,2,8,10,23,1
182.0,2,3,2,9,12,24,2
182.0,2,4,2,8,12,25,3
182.0,2,3,2,6,9,26,4
182.0,2,3,2,6,9,27,5
182.0,2,2,1,2,4,28,1
182.0,3,2,1,2,4,40,2
182.0,3,3,2,6,9,41,1
182.0,3,1,1,3,4,42,1
182.0,3,2,1,2,4,43,2
182.0,3,2,1,2,4,44,3
182.0,3,1,1,3,4,45,4
182.0,3,3,2,8,11,46,1
182.0,3,3,2,6,9,47,2
182.0,3,0,1,3,3,48,1
182.0,3,2,1,2,4,49,2
182.0,3,-6,2,7,1,50,1
182.0,4,0,0,2,2,60,1
182.0,4,0,0,2,2,61,2
182.0,4,0,0,2,2,62,3
182.0,4,0,2,8,8,63,1
182.0,4,0,2,7,7,64,2
182.0,4,0,2,6,6,65,3
182.0,4,1,2,5,6,66,4
182.0,4,3,2,7,10,67,5
182.0,4,4,2,5,9,68,6
182.0,4,0,0,2,2,69,1
182.0,4,0,0,2,2,70,2
182.0,5,1,1,3,4,80,1
182.0,5,3,1,2,5,81,2
182.0,5,2,1,3,5,82,3
182.0,5,1,1,2,3,83,4
182.0,5,1,1,2,3,84,5
182.0,5,1,1,2,3,85,6
182.0,5,1,1,2,3,86,7
182.0,5,1,1,2,3,87,8
182.0,5,1,1,3,4,88,9
182.0,5,2,1,2,4,89,10
182.0,5,2,1,2,4,90,11
182.0,5,2,1,2,4,91,12
182.0,5,1,1,3,4,92,13
183.0,1,0,0,2,2,0,1
183.0,1,0,0,2,2,1,2
183.0,1,0,1,3,3,2,1
183.0,1,5,1,2,7,3,2
183.0,1,1,1,3,4,4,3
183.0,1,2,2,6,8,5,1
183.0,1,3,2,7,10,6,2
183.0,1,2,2,7,9,7,3
183.0,1,0,0,2,2,8,1
183.0,1,1,0,2,3,9,2
183.0,1,1,0,2,3,10,3
183.0,2,0,0,2,2,20,4
183.0,2,0,0,2,2,21,5
183.0,2,0,0,2,2,22,6
183.0,2,2,2,7,9,23,1
183.0,2,3,2,7,10,24,2
183.0,2,3,2,7,10,25,3
183.0,2,2,2,6,8,26,4
183.0,2,3,2,7,10,27,5
183.0,2,1,1,3,4,28,1
183.0,2,-3,2,8,5,29,1
183.0,3,1,1,2,3,40,1
183.0,3,0,2,8,8,41,1
183.0,3,1,1,2,3,42,1
183.0,3,1,1,2,3,43,2
183.0,3,0,1,3,3,44,3
183.0,3,0,1,3,3,45,4
183.0,3,3,2,7,10,46,1
183.0,3,3,2,5,8,47,2
183.0,3,2,1,2,4,48,1
183.0,3,2,1,2,4,49,2
183.0,3,2,2,6,8,50,1
183.0,4,0,0,2,2,60,1
183.0,4,0,0,2,2,61,2
183.0,4,0,0,2,2,62,3
183.0,4,0,2,6,6,63,1
183.0,4,0,2,7,7,64,2
183.0,4,0,2,6,6,65,3
183.0,4,3,2,7,10,66,4
183.0,4,3,2,7,10,67,5
183.0,4,2,2,6,8,68,6
183.0,4,1,0,2,3,69,1
183.0,4,-1,0,2,1,70,2
183.0,5,1,1,2,3,80,1
183.0,5,1,1,2,3,81,2
183.0,5,1,1,2,3,82,3
183.0,5,0,1,3,3,83,4
183.0,5,0,1,3,3,84,5
183.0,5,1,1,2,3,85,6
183.0,5,0,1,3,3,86,7
183.0,5,2,1,2,4,87,8
183.0,5,1,1,3,4,88,9
183.0,5,1,1,3,4,89,10
183.0,5,2,1,2,4,90,11
183.0,5,2,1,2,4,91,12
183.0,5,2,1,2,4,92,13
184.0,1,0,0,2,2,0,1
184.0,1,0,0,2,2,1,2
184.0,1,1,1,3,4,2,1
184.0,1,1,1,3,4,3,2
184.0,1,4,1,3,7,4,3
184.0,1,2,2,8,10,5,1
184.0,1,3,2,6,9,6,2
184.0,1,3,2,7,10,7,3
184.0,1,0,0,2,2,8,1
184.0,1,0,0,2,2,9,2
184.0,1,1,0,2,3,10,3
184.0,2,1,0,2,3,20,4
184.0,2,0,0,2,2,21,5
184.0,2,1,0,2,3,22,6
184.0,2,4,2,8,12,23,1
184.0,2,2,2,7,9,24,2
184.0,2,4,2,7,11,25,3
184.0,2,3,2,7,10,26,4
184.0,2,4,2,5,9,27,5
184.0,2,1,1,3,4,28,1
184.0,3,2,1,2,4,40,2
184.0,3,4,2,8,12,41,1
184.0,3,2,1,2,4,42,1
184.0,3,2,1,2,4,43,2
184.0,3,2,1,2,4,44,3
184.0,3,2,1,2,4,45,4
184.0,3,4,2,5,9,46,1
184.0,3,3,2,6,9,47,2
184.0,3,1,1,2,3,48,1
184.0,3,1,1,3,4,49,2
184.0,4,1,0,2,3,60,1
184.0,4,1,0,2,3,61,2
184.0,4,1,0,2,3,62,3
184.0,4,2,2,7,9,63,1
184.0,4,3,2,8,11,64,2
184.0,4,3,2,7,10,65,3
184.0,4,2,2,7,9,66,4
184.0,4,3,2,6,9,67,5
184.0,4,3,2,6,9,68,6
184.0,5,2,1,2,4,80,1
184.0,5,2,1,2,4,81,2
184.0,5,2,1,2,4,82,3
184.0,5,2,1,2,4,83,4
184.0,5,2,1,2,4,84,5
184.0,5,1,1,3,4,85,6
184.0,5,1,1,3,4,86,7
184.0,5,2,1,2,4,87,8
184.0,5,2,1,2,4,88,9
184.0,5,2,1,2,4,89,10
184.0,5,1,1,3,4,90,11
184.0,5,1,1,3,4,91,12
184.0,5,-2,1,3,1,92,13
188.0,1,-1,0,2,1,0,1
188.0,1,-1,0,2,1,1,2
188.0,1,-1,1,2,1,2,1
188.0,1,1,1,3,4,3,2
188.0,1,1,1,3,4,4,3
188.0,1,3,2,7,10,5,1
188.0,1,3,2,6,9,6,2
188.0,1,4,2,6,10,7,3
188.0,1,1,0,2,3,8,1
188.0,1,1,0,2,3,9,2
188.0,1,0,0,2,2,10,3
188.0,1,0,0,2,2,11,4
188.0,2,0,0,2,2,20,5
188.0,2,0,0,2,2,21,6
188.0,2,0,0,2,2,22,7
188.0,2,3,2,6,9,23,1
188.0,2,4,2,8,12,24,2
188.0,2,3,2,8,11,25,3
188.0,2,4,2,6,10,26,4
188.0,2,2,2,6,8,27,5
188.0,2,2,1,2,4,28,1
188.0,2,-4,2,6,2,29,1
188.0,3,1,1,2,3,40,1
188.0,3,0,2,7,7,41,1
188.0,3,1,1,2,3,42,1
188.0,3,1,1,2,3,43,2
188.0,3,1,1,2,3,44,3
188.0,3,0,1,3,3,45,4
188.0,3,0,2,6,6,46,1
188.0,3,3,2,6,9,47,2
188.0,3,1,1,2,3,48,1
188.0,3,1,1,2,3,49,2
188.0,3,2,2,6,8,50,1
188.0,3,-5,2,7,2,51,2
188.0,4,0,0,2,2,60,1
188.0,4,0,0,2,2,61,2
188.0,4,0,0,2,2,62,3
188.0,4,0,2,7,7,63,1
188.0,4,0,2,6,6,64,2
188.0,4,0,2,7,7,65,3
188.0,4,0,2,7,7,66,4
188.0,4,3,2,5,8,67,5
188.0,4,2,2,7,9,68,6
188.0,4,0,0,2,2,69,1
188.0,4,0,0,2,2,70,2
188.0,5,2,1,2,4,80,1
188.0,5,2,1,2,4,81,2
188.0,5,2,1,2,4,82,3
188.0,5,2,1,2,4,83,4
188.0,5,2,1,2,4,84,5
188.0,5,2,1,2,4,85,6
188.0,5,2,1,3,5,86,7
188.0,5,2,1,2,4,87,8
188.0,5,2,1,2,4,88,9
188.0,5,2,1,2,4,89,10
188.0,5,2,1,2,4,90,11
188.0,5,1,1,3,4,91,12
190.0,1,0,0,2,2,0,1
190.0,1,1,0,2,3,1,2
190.0,1,1,1,3,4,2,1
190.0,1,1,1,3,4,3,2
190.0,1,1,1,3,4,4,3
190.0,1,4,2,6,10,5,1
190.0,1,2,2,6,8,6,2
190.0,1,3,2,7,10,7,3
190.0,1,2,0,2,4,8,1
190.0,1,1,0,2,3,9,2
190.0,1,0,0,2,2,10,3
190.0,2,1,0,2,3,20,4
190.0,2,0,0,2,2,21,5
190.0,2,0,0,2,2,22,6
190.0,2,0,2,7,7,23,1
190.0,2,0,2,7,7,24,2
190.0,2,0,2,7,7,25,3
190.0,2,4,2,6,10,26,4
190.0,2,4,2,8,12,27,5
190.0,2,2,1,2,4,28,1
190.0,2,3,2,5,8,29,1
190.0,3,1,1,2,3,40,1
190.0,3,0,2,7,7,41,1
190.0,3,0,1,3,3,42,1
190.0,3,1,1,2,3,43,2
190.0,3,1,1,2,3,44,3
190.0,3,1,1,2,3,45,4
190.0,3,0,2,8,8,46,1
190.0,3,0,2,6,6,47,2
190.0,3,1,1,2,3,48,1
190.0,3,1,1,3,4,49,2
190.0,3,4,2,7,11,50,1
190.0,4,0,0,2,2,60,1
190.0,4,0,0,2,2,61,2
190.0,4,1,0,2,3,62,3
190.0,4,4,2,5,9,63,1
190.0,4,4,2,7,11,64,2
190.0,4,3,2,7,10,65,3
190.0,4,4,2,5,9,66,4
190.0,4,4,2,8,12,67,5
190.0,4,2,2,6,8,68,6
190.0,5,0,1,3,3,80,1
190.0,5,1,1,2,3,81,2
190.0,5,1,1,2,3,82,3
190.0,5,1,1,2,3,83,4
190.0,5,1,1,2,3,84,5
190.0,5,1,1,2,3,85,6
190.0,5,1,1,2,3,86,7
190.0,5,0,1,3,3,87,8
190.0,5,1,1,2,3,88,9
190.0,5,1,1,3,4,89,10
190.0,5,2,1,2,4,90,11
190.0,5,2,1,2,4,91,12
190.0,5,2,1,2,4,92,13
190.0,5,-1,1,2,1,93,14
192.0,1,1,0,2,3,0,1
192.0,1,0,0,2,2,1,2
192.0,1,1,1,3,4,2,1
192.0,1,-2,1,3,1,3,2
192.0,1,-2,1,3,1,4,3
192.0,1,-7,2,8,1,5,1
192.0,1,-7,2,8,1,6,2
192.0,1,3,2,7,10,7,3
192.0,1,0,0,2,2,8,1
192.0,1,1,0,2,3,9,2
192.0,1,1,0,2,3,10,3
192.0,1,0,0,2,2,11,4
192.0,1,0,0,2,2,12,5
192.0,1,-1,2,9,8,13,1
192.0,2,0,0,2,2,20,1
192.0,2,1,0,2,3,21,2
192.0,2,1,0,2,3,22,3
192.0,2,3,2,8,11,23,1
192.0,2,3,2,7,10,24,2
192.0,2,3,2,7,10,25,3
192.0,2,3,2,6,9,26,4
192.0,2,3,2,7,10,27,5
192.0,2,2,1,2,4,28,1
192.0,3,1,1,3,4,40,2
192.0,3,4,2,5,9,41,1
192.0,3,1,1,3,4,42,1
192.0,3,1,1,3,4,43,2
192.0,3,1,1,3,4,44,3
192.0,3,2,1,2,4,45,4
192.0,3,3,2,6,9,46,1
192.0,3,4,2,6,10,47,2
192.0,3,2,1,2,4,48,1
192.0,3,1,1,3,4,49,2
192.0,3,-6,2,7,1,50,1
192.0,4,0,0,2,2,60,1
192.0,4,0,0,2,2,61,2
192.0,4,0,0,2,2,62,3
192.0,4,0,2,7,7,63,1
192.0,4,0,2,6,6,64,2
192.0,4,0,2,7,7,65,3
192.0,4,2,2,6,8,66,4
192.0,4,0,2,6,6,67,5
192.0,4,0,2,6,6,68,6
192.0,4,0,0,2,2,69,1
192.0,4,1,0,2,3,70,2
192.0,4,-5,2,7,2,71,1
192.0,5,0,1,3,3,80,1
192.0,5,0,1,3,3,81,2
192.0,5,1,1,2,3,82,3
192.0,5,1,1,2,3,83,4
192.0,5,1,1,2,3,84,5
192.0,5,0,1,3,3,85,6
192.0,5,1,1,2,3,86,7
192.0,5,1,1,3,4,87,8
192.0,5,1,1,3,4,88,9
192.0,5,1,1,3,4,89,10
192.0,5,1,1,3,4,90,11
192.0,5,2,1,2,4,91,12
192.0,5,2,1,2,4,92,13
195.0,1,1,0,2,3,0,1
195.0,1,1,0,2,3,1,2
195.0,1,1,1,3,4,2,1
195.0,1,1,1,3,4,3,2
195.0,1,1,1,3,4,4,3
195.0,1,2,2,7,9,5,1
195.0,1,2,2,7,9,6,2
195.0,1,2,2,6,8,7,3
195.0,1,0,0,2,2,8,1
195.0,1,2,0,2,4,9,2
195.0,1,0,0,2,2,10,3
195.0,1,-1,0,2,1,11,4
195.0,2,0,0,2,2,20,5
195.0,2,0,0,2,2,21,6
195.0,2,0,0,2,2,22,7
195.0,2,2,2,7,9,23,1
195.0,2,4,2,6,10,24,2
195.0,2,4,2,7,11,25,3
195.0,2,3,2,6,9,26,4
195.0,2,4,2,6,10,27,5
195.0,2,1,1,3,4,28,1
195.0,2,-3,2,6,3,29,1
195.0,3,1,1,2,3,40,1
195.0,3,0,2,7,7,41,1
195.0,3,0,1,3,3,42,1
195.0,3,1,1,2,3,43,2
195.0,3,1,1,2,3,44,3
195.0,3,2,1,2,4,45,4
195.0,3,2,2,7,9,46,1
195.0,3,4,2,7,11,47,2
195.0,3,2,1,2,4,48,1
195.0,3,2,1,2,4,49,2
195.0,3,1,2,5,6,50,1
195.0,4,0,0,2,2,60,1
195.0,4,0,0,2,2,61,2
195.0,4,0,0,2,2,62,3
195.0,4,0,2,7,7,63,1
195.0,4,0,2,7,7,64,2
195.0,4,3,2,7,10,65,3
195.0,4,5,2,6,11,66,4
195.0,4,2,2,7,9,67,5
195.0,4,3,2,6,9,68,6
195.0,4,1,0,2,3,69,1
195.0,5,2,1,3,5,80,1
195.0,5,2,1,2,4,81,2
195.0,5,2,1,2,4,82,3
195.0,5,2,1,2,4,83,4
195.0,5,2,1,2,4,84,5
195.0,5,2,1,2,4,85,6
195.0,5,2,1,2,4,86,7
195.0,5,1,1,3,4,87,8
195.0,5,2,1,2,4,88,9
195.0,5,2,1,2,4,89,10
195.0,5,2,1,2,4,90,11
195.0,5,2,1,2,4,91,12
196.0,1,-1,0,2,1,0,1
196.0,1,-1,0,2,1,1,2
196.0,1,1,1,2,3,2,1
196.0,1,2,1,3,5,3,2
196.0,1,1,1,3,4,4,3
196.0,1,3,2,7,10,5,1
196.0,1,3,2,6,9,6,2
196.0,1,1,2,7,8,7,3
196.0,1,0,0,2,2,8,1
196.0,1,0,0,2,2,9,2
196.0,1,0,0,2,2,10,3
196.0,1,0,0,2,2,11,4
196.0,2,0,0,2,2,20,5
196.0,2,0,0,2,2,21,6
196.0,2,0,0,2,2,22,7
196.0,2,0,2,8,8,23,1
196.0,2,3,2,6,9,24,2
196.0,2,2,2,7,9,25,3
196.0,2,4,2,5,9,26,4
196.0,2,2,2,7,9,27,5
196.0,2,2,1,2,4,28,1
196.0,2,0,2,8,8,29,1
196.0,3,1,1,2,3,40,1
196.0,3,0,2,7,7,41,1
196.0,3,1,1,2,3,42,1
196.0,3,1,1,2,3,43,2
196.0,3,1,1,2,3,44,3
196.0,3,1,1,2,3,45,4
196.0,3,4,2,5,9,46,1
196.0,3,3,2,6,9,47,2
196.0,3,2,1,2,4,48,1
196.0,3,2,1,2,4,49,2
196.0,3,3,2,6,9,50,1
196.0,4,0,0,2,2,60,1
196.0,4,0,0,2,2,61,2
196.0,4,0,0,2,2,62,3
196.0,4,1,2,5,6,63,1
196.0,4,0,2,9,9,64,2
196.0,4,0,2,6,6,65,3
196.0,4,3,2,7,10,66,4
196.0,4,4,2,6,10,67,5
196.0,4,4,2,6,10,68,6
196.0,4,1,0,2,3,69,1
196.0,5,2,1,2,4,80,1
196.0,5,2,1,2,4,81,2
196.0,5,2,1,2,4,82,3
196.0,5,2,1,2,4,83,4
196.0,5,2,1,2,4,84,5
196.0,5,2,1,2,4,85,6
196.0,5,2,1,2,4,86,7
196.0,5,2,1,2,4,87,8
196.0,5,2,1,2,4,88,9
196.0,5,2,1,2,4,89,10
196.0,5,2,1,2,4,90,11
196.0,5,2,1,2,4,91,12
196.0,5,-2,1,3,1,92,13
197.0,1,-1,0,2,1,0,1
197.0,1,0,0,2,2,1,2
197.0,1,1,1,3,4,2,1
197.0,1,2,1,2,4,3,2
197.0,1,1,1,3,4,4,3
197.0,1,3,2,6,9,5,1
197.0,1,4,2,6,10,6,2
197.0,1,2,2,7,9,7,3
197.0,1,1,0,2,3,8,1
197.0,1,1,0,2,3,9,2
197.0,1,1,0,2,3,10,3
197.0,1,-1,0,2,1,11,4
197.0,2,0,0,2,2,20,5
197.0,2,0,0,2,2,21,6
197.0,2,0,0,2,2,22,7
197.0,2,0,2,6,6,23,1
197.0,2,2,2,6,8,24,2
197.0,2,3,2,6,9,25,3
197.0,2,3,2,6,9,26,4
197.0,2,0,2,7,7,27,5
197.0,2,2,1,2,4,28,1
197.0,2,3,2,7,10,29,1
197.0,3,2,1,2,4,40,1
197.0,3,4,2,6,10,41,1
197.0,3,2,1,2,4,42,1
197.0,3,1,1,3,4,43,2
197.0,3,1,1,3,4,44,3
197.0,3,2,1,3,5,45,4
197.0,3,4,2,7,11,46,1
197.0,3,3,2,7,10,47,2
197.0,3,2,1,2,4,48,1
197.0,3,2,1,2,4,49,2
197.0,4,1,0,2,3,60,1
197.0,4,1,0,2,3,61,2
197.0,4,0,0,2,2,62,3
197.0,4,3,2,7,10,63,1
197.0,4,3,2,6,9,64,2
197.0,4,3,2,6,9,65,3
197.0,4,3,2,6,9,66,4
197.0,4,3,2,7,10,67,5
197.0,4,3,2,6,9,68,6
197.0,5,3,1,2,5,80,1
197.0,5,2,1,2,4,81,2
197.0,5,2,1,2,4,82,3
197.0,5,2,1,2,4,83,4
197.0,5,1,1,3,4,84,5
197.0,5,2,1,2,4,85,6
197.0,5,2,1,2,4,86,7
197.0,5,2,1,2,4,87,8
197.0,5,1,1,3,4,88,9
197.0,5,2,1,2,4,89,10
197.0,5,2,1,2,4,90,11
197.0,5,2,1,2,4,91,12
